####################################################################################################
#       #               #     #       #     #         #         #       #       #             #     
# ####### ####### ##### # ##### # ### ### # # ######### # ####### # ### # ### ### ##### ##### ##### 
#   #     #     #   #   #     # #   #     #   #     #   #         # # # #   #     #   #   # #       
# # # ######### ### # ### ### # ### ######### # ### # ############# # # ### ####### # ### # ####### 
# # #             # # # # # #   # #       #   # # # #   #   # #     #   #   #     # #   # #     #   
# # ############# # # # # # ##### ####### # ### # # ### # # # # ####### # ##### # # ### # # ### # ##
# #   #     #     # # #           #   #   #   #   #     # #   # #     # # #   # # #   #   #   #     
### # ##### # ##### # ####### ##### # # # ####### ####### ### # # ### ### # # # # ### ### ##########
#   #     # #   # # #     #   #   # #   # #       #       # # # #   #     # #   # #   # # #   #     
# ####### # ### # # ##### ##### # # # ##### ############# # # # ### ####### ### ### ### # # # # ### 
#   #       #   # #     #       #   # #   # #           # # # #     #   #   #   #   #     # # # # # 
### # ####### ### ##### ############# # # # # ### ##### # # # ####### ### # # ### # ####### # # # # 
#   # # #     # #     #     #       # # #   #   # #   #   #   #     #     # # #   # #       #   # # 
# ### # # ##### # # ####### # # # ### # ####### # ### ##### ### ### # ##### ### ##### ########### # 
# # # # # #       #       # # # # #   # #   #   # #       #     #   # #   #   # #     #       #   # 
# # # # # ##### ##### ##### # # ### ### ### # ### # ### ######### ##### # # # # # ####### ### # ### 
# # #   #     #     # #     # #       #   #   #   # # # #     #   #   # # # # #   #     #   #   #   
# # # ####### # ##### # # ############### # ### ### # # # ### # ### # # # ### ##### # # ### ### # # 
# #   #       # #     # # #       #       #   # #   #   # #   #     #   #   #       # #     # # # # 
# ##### ######### ### # ### ##### # ######### # ### ##### # # ############# # ####### ####### # # # 
#       # #       #   #   # #   # # #   #   # #   #       # # #       #   # # #   #   # #     # # # 
# ####### # ### ### ##### # # # # # # # # # # ### ### ##### # # ##### # # # # # # # ### # # ### # ##
# #     #     # #   # #   # # # # # # # # #   # #   # #   # # #   # #   # # # # #   #     #     #   
# ### # ####### # ### # ### # # # # # # # ##### ### # ### # # ### # # ##### # # ################# # 
#     #         #     #   # # # # #   # # #     #   #     # #     #   #     # #         #       # # 
##################### ### # # ### ##### # # ##### ### ##### ########### ########### ### # ##### ### 
#         #     #   # # #   # #     #   # # #     #   #   # #   #       #         # #   # # #   #   
# ####### # ### # ### # ##### # ### # ### # # ######### # # # # # ########### ### ### # # # # ### # 
#     #   #   #   #   #   #   # #   # #     #     #     # # # #               #   #   # # #       # 
# ### # ### # ### # ### # ### # # ### ##### ##### # ##### # # ################### # # ### # ########
#   # #   # # #   #     #     # #   #     #     #   #     # # #   #             #   # #   #   #     
# ### ### ### # ####### ####### ### ##### ### ####### ##### # # # # # ######### ####### ####### ### 
# #   #   #   # #   #   #       #       # # # #     # # #   #   # # # #       #   #   # #       #   
# # ### ### ### # # # ### ##### ######### # # # ### # # # # ### ### ### ##### ### # # # # ####### ##
# # # # #   #   # #   # # #   # #         #   # #     #   # #   #   #     E # #     # #   #       # 
# # # # # # ##### ##### # ### # # ######### ### ########### # ### ### ####### ####### ##### ####### 
# # #     # #     #     #   #   # #       #   #     #     # # # #     #     #   #     #     #       
# # ######### ####### ##### # ### # ##### ####### # # ### # # # ####### ### ### # ##### ##### ### # 
# # #     #   #       #     #   # #   # #       # # #   # #       #   # # #     # #       # # #   # 
# # # ### # ### ### # # ####### # # # # ####### ### # ### ####### # # # # ####### ####### # # # ####
# # #   #   # #   # # #   #     # # # #   #     #   # #   #     # #S#   #   #   # #       #   #     
# # ### ##### # ### # ### ### ### ### # # # ##### # # # ### ### ######### ### # # # ####### ####### 
# #     #       #   # # #   #   #     # # # #     # # # #     #     #         #   #     #   #   #   
# ######### ##### ### # ### ########### ### # # ### # # # ######### # ################# # ### # # # 
#         # # #   #   #   #   #         #   # #   # # #   # #     # #         #         #   # # # # 
######### # # # ### ##### ### # # ### ### ### ### # # ##### # ### # ######### # ############# # # # 
#       # # # # #   #     # #   # #   #   # #   # # #     # #   #   #       #   #   #         #   # 
# ### # # # # # ### # ### # ##### # ### ### ### # ####### # ### ### # ##### ##### # # # ############
# # # # # #   #   #   #   #   #   #   # #     # #       # #   # #     #     #     # # #             
# # # ### ####### ##### ### ### ##### # ### # # ### ### # # ### ####### ##### ##### ### ########### 
# # #     #     # # #   #     #     # #   # #     #   # # #   # #   # #   #   #   #   #   #       # 
# # ####### ### # # # ### ### ##### ##### ########### # # ### # # # # ### # # # # ### ### ####### # 
#   #       # #   #   #   # #     # #     #   #   #   # # #   #   # #     # # # # #   #       #   # 
### # ####### ##### ### ### # ##### # ##### # # # # ##### # # ##### # ##### # # # # ######### # ### 
#   #   #         # #       #   #   # #     #   #   #     # #   #   #     # # # # #         # # #   
# ### # # ####### # ########### # ### # ### ######### ##### ### # ####### ### ### ######### # # # ##
# #   # # #     # #             #     #   # #       #   #   #   # # #   #     #       #     #   #   
# ##### # # ### ############### ####### # # # ##### ### # ### ### # # # ####### ##### # ####### ### 
#       # #   #           #     #   #   # # #     #     # #   #   #   #       #     # # #   #   # # 
######### # ####### ### ### ##### # ##### ####### ####### ##### ### ######### # ### ### # # # ### # 
#     #   # #     # #   #   #     #     # #     # #       #     # # #       #   # #     # # #   # # 
##### # # # # ### ### ### ### ######### # # ### # # ####### ##### # # # ### ##### ####### # ### # # 
#     # # # #   #     #   #   #     #   #   # #     #     # #     # # #   #   #   #     # # #     # 
# ##### # # ### # ##### ### # # ### # ### ### ####### ### # ##### # ##### ### # # # ### # # ####### 
#       #   #   # #     #   #   #   # #   #     #   # #   #     #   #     # #   # #   #   #       # 
# ########### # ### ############# ### ### ### ### # # ### ##### # ### ##### ##### ### ########### # 
# #       # # # #   #             # #   #     #   # #   #     # # #   #         # #   #   #     # # 
# ##### # # # ### ### ############# ### ####### ### ### ##### # # ### # # ####### # ### ### # ### # 
#     # # # #     #           #   #   #       #   #     #   #   # #   # #         # #   #   #   # # 
##### # # # ############# ### # ### # ####### ### ######### ##### # ### ########### # ### ##### # # 
#   #   # # #           # #   #     #       #     #         #   # #   #       #     # #   #   #   # 
# # ##### # # ##### ### # # ######### ##### ######### ##### # # # ### ####### # ##### # ### ####### 
# # #   # #   #     #   # # #     #   #       #       #   # # # # #   #     # #   #   #   # #       
# ### # # ##### ##### ### # ### # # # ####### ### ##### ### # # # # ### ### # ### # ##### # # ### # 
#   # # #     # #     #   #   # # # # #     #     # #       # # #   # #   # #     # #     #   #   # 
# # # # ##### # # ####### ### # # # # # ### ####### # ####### # ##### ### # ####### # ##### ### ### 
# #   #     #   #       # #   # #   # # # # #     #   #     # # #       # #         # # #   #   #   
# ####### ############# ### ### ##### # # # ##### # ##### ### # # ### # # ######### # # # ### ##### 
# #     # #           #   #   # # #   #   #   #   # #   #     # # #   # # #   #   #   #   # #     # 
# ### # # # ######### ### ### # # # ### ##### # ### # # ####### # # ##### # # # ####### ### ##### ##
#     # #   #   #   #   # #   # #   # # #     #   #   #         # # #   # # # #       #   #     #   
##### ####### # # # ### # # ### # ### # # ####### ### ######### # # # # # # # # ### # ### ### # ### 
# #   #       #   #   # #   #   #     # # #     #     #       # # #   # #   # #   # #   # #   # # # 
# # ### ############# # ##### ##### ### # # ### ### ### ##### ### ##### ##### ### # ##### # ### # # 
# # #   #           #   #   #     # #   # # # #   #   #   #   #   #   #     #   # #         #   # # 
# # # ############# ### ### # ### # # ### # # ### ####### # # # ### ####### ### # ############# # # 
# # #       #     #   #     # # # # # #   # #   # #       # # # # #       #   # #       #     # # # 
# # ####### # ### ### # ##### # # ### # # # ### # # ####### ### # # ### ### ### ### ##### ### # # # 
# #   #   # #   #   #   #     # #     # # #   # #   # #   # #   #     # #   #   #   #   # #   # # # 
# ### # # # # ##### # ### ##### ####### ##### # ##### # # # # ### ##### # ### ### ### # # # ### # # 
#   #   # #   #   # #   #     #       #       #         # #   #   #   # #     #   #   #   #   #   # 
# ####### ##### # # # ####### # ##### ################### ######### # # ########### ### ##### ##### 
#       #     # #   # #     # # #   # #           #     # #       # #             # #   #   #       
# ##### # ##### ##### # # # # # # # # ##### ##### # ### # # # ### # ############# # ##### # ####### 
# #   #   #   # #     # # # # #   # # #   # #     #   # #   # #   #   #       #   #     # # #     # 
# # # ##### # # ####### # ### ##### # # # # ##### ### # # ### # ##### # ### ### ##### # # # # ### # 
#   #     # #   #       #   #       #   # #     # #   # #   # # #   # # # #   #     # #   # #   # # 
######### # ##### ######### ############# ##### # # ### ##### # # # # # # ### ##### ####### ### # # 
#         #               #                     #   #         #   #   #     #               #   #   
