# E #
### #
#S# #
# # #
#   #
