####################################################################################################
       #         # #       #               #     #             #         #   #     #           #   #
 ##### # ####### # # # ##### # ### ####### ##### # ##### ##### # ####### # ### # ### ##### ### ### #
 # #   # # #   # # # #       # #   #   # #     # # #   # #   # #   #   #   #   #     #   # # #   # #
 # # ### # # # # # # ######### ##### # # ##### # # # # # ### # ### # # ##### ######### # # # ### # #
 #   #   #   # #   #     #     #     # # #   # # # # # #   # #   #   #     # #   #     # # #   # # #
 # ##### ##### ### ##### # # ### ##### # # # # # # ### ### # ### ######### # # # ####### # ### # # #
 #   #   #   #     #   # # # #     #   # # #   # #     #   #   #   #       # # #       # #   # #   #
 ### # # # # # ##### # # # ### ##### ### # ##### ##### # ### # ### # ####### # ####### # ### # ### #
 #     # # # # #     #   # #   #     #   #     # #   # # #   #   # #       # #   #         # # #   #
 ######### # ### ######### # ### ##### # ##### # # # # # ### ### # ####### # ### # ####### # # # ###
         # #   # #       #   # #     # #     # # # # # #   #   # # #     #       #   #   # # # # # #
 ####### # ### # # ##### ##### ##### # # # ### # # # # ### ### # # # ### ########### # # # # # # # #
 #       #   #   #   #         #     # # # #   #   #   # #   # # # # #         #   # # # # # #   # #
 # ######### ####### ########### ####### # # ### ####### ### # ### # ######### # # # # # ### # ### #
 #     #     #     # #   #   #   #       # # # # #   #   #   #     #     #   # # #   # #     # #   #
 ##### # ##### ### # # # # # # ### ##### ### # # # # # # # ##### ####### ### # ####### ####### ### #
 #   #   #     #   # # #   #   # #     # #   # # # # # # # #   #         #   #     #   #     #     #
 # # ######### # ### # ######### # ### # # ### # # # # # # # # # ######### ####### # ### ######### #
 # #     #   # #     #   #         #   # # #   # # #   # #   # # #     # #   #     #   #         # #
 ##### # # # # ####### # ########### ### # # ### # ##### ##### ### ### # # # # ##### # # ### # ### #
       #   #   #     # #     #     #   # # # #     #   # #   #       # # # #   #     # #   # # #   #
########## ##### ### ####### # ### ### ### # # ##### # ### # ######### # # ##### ##### ### # # # ###
         # #     # #       # # # #   # #   #     #   # #   # #     #   # #   #   #     #   # # #   #
 ####### # # ##### ####### # # # ### # # ### ##### ### # ### # ### # ### ### # ### ######### # ### #
 #   # # # # #   #       # #   #   # # #   # #   # #   # # #   # #   #     # #   # #         # # # #
 # # # # ### # # # ##### # # ##### # # ### ### # # # ### # ##### ######### # ##### # ######### # # #
   # # # #   # # #     # # #       # #         #   #   # #         #     # #   #   #   #         # #
#### # # # ### # ####### # ####### # # ############### # # ##### # # # # # ### # ### # ##### ##### #
     # # # #   #       # #     #   # #   #   #   #     # #     # # # # #     # # #   #     # #   # #
 ##### # # # ######### # ##### # ### ##### # # ### ##### # ##### ### # ##### # # # ####### # # # # #
   #     # # #       # #   #   #   #     # # #   # #     # #     #   # #   # #   #   # #   # # #   #
## # ##### # # # ##### # ### ##### ##### # # ### # # ##### # ##### ### # ### ####### # # ### # #####
   # #     # # # #     #   #     # #   #   #   #     #   # #   #   #   #           # # #   # #     #
 ### # ##### # ### ##### # ##### # # # ####### ####### ### ### # ### ############### # ### # ##### #
 # #   #     # #   # #   #       # # # #     #     #       # #   # #               #   # # #     # #
 # ### # ##### # ### # ########### # # ### ####### # ####### ##### ############### ### # # # ##### #
 #     # #     #   #   #   #   #   # #   #       # #       #       #   # #       #   #   # # #     #
 ##### # # # # ### ### # # # # # ### ### ### ### # ####### # ##### # # # # # ##### ##### # ### #####
     # # # # #   #   # # #   # #     #     # #   # # #   #   #     # # #   # #   #       #     #   #
 ### ### ### # ##### # ####### ##### ##### # ##### # # # ##### ##### # ##### # # ########### ##### #
 # #   # #   # #     # #     # #     #   #   #   # #   #             #     #   # #         #       #
 # ### # # ##### ##### # ### # # ##### # ##### # # ##### ################# ##### # ####### ####### #
 # #   # #   #   #       #   # # #   # #   #   # # #   # #   #   #       # #   # # #     #     # # #
 # # ### ### # ############# # # # # # ### # ### # # # # # # # # ##### ### # # # # # ### ##### # # #
 # # #       #       #S    # # # # # # # # # # # #   # # # #   #   #   #   # #   #   #   #   # # # #
 # # # ############# ##### # # # # ### # # # # # ##### # # ####### # ### ### # ####### ### # # # # #
   # #   #               # # #     #   #     # # #     # # #     # #     #   # #           # # # # #
#### # ### ### ######### # # ##### # ######### # # ####### # ### # # ##### ##### ########### # # # #
   # # #   #   #       # # #     # #     #   #   #   #     # #   # # #     #     #       #   # # # #
 # # # # #####E# ##### ### ##### ####### ### # ### # # ##### # # # # ### # # ##### ##### ##### # # #
 #   # #     # # #   #   #   # #         #   # #   # # #     # # # #   # # # #   # #     #   # #   #
 ### # ##### ### # ##### ### # ########### ### ##### # # ##### # # ### # # # # ### # ##### # # # ###
   # # #   #     #     # #   #       #       #     #   # #     # # # # # # #   #   #   #   #   #   #
## ### # # ######### ### # ### ####### ##### ##### # ##### ####### # # # # ### # ##### ### ####### #
 # #   # # #         #   # # #     #   #         # #       #     # # #   # #   # #       # #       #
 # # ### ### ##### ### ### # # ### # ### ####### # ### ##### ### # # ##### # ### ####### # # #######
 # #   #     # #   #   #   #     #     # #     # # #   #     #   # #       # # #     # #   #     # #
 # ### # ##### # ### ### ##### ##### ### # # ### # # ### ##### ### ######### # ##### # ######### # #
 # #   # #     #   #   #     # #   # #   # #     # #   # #   # #       #         #   # #   #     # #
 # # ### # ### ### ### ##### ### # ### ### ####### ##### # # # ##### # # ######### ### # # # ##### #
 # #   # # #   # #   #       #   #     # # #   # #   #   # # #     # #   #         #   # #   # #   #
 # ### # ### # # # ########### ######### # # # # ### # ### # ##### ####### ########### # ##### # # #
 #     #     #   #     #       #       #   # #   #   #   # #     # #       #           #     #   # #
 ########### ####### ### ##### # ##### ### # ### # ##### # ### # # # ############### # ##### ##### #
           # #     # #   #     # #   #   # #   # #   #   #   # # #   #         #     # #   # #     #
 ######### ### ### # # ### ### # ### ### # ### # ### # ### ### # ##### ### ### # ### ### # # # ### #
 #       #     #   # #   #   # # #     # #     #   #   # # #   #   # # #   # # #   # #   #   #   # #
 # ############# ### ### ### # # # ### # ############### # # ##### # # # ### # ### # # ######### # #
 #   #             #     #   # #   #   #     #         #   #   #     # #   # #   # # # #   #     # #
 ### # ########### ##### # ######### ####### # ##### # ####### # ##### ### # ### # # # # # # ##### #
   #   #         #     # #   #           #   # #   # #         #   #   #   #       # #   #   # #   #
 # ##### ####### ##### ##### # ########### # # ### # ####### ####### ### ### ####### ######### # ###
 #         #   # # #         # #           # #     #     #   #   #   #   #   #   #           # # # #
 ######### # # # # # ####### # # ### ############# ##### ### # # # ### ####### # ########### # # # #
 #       # # # # #   #   #   # # # # #                 #   # # #   # #         #       #     # #   #
## ##### # # ### # ### # ##### # # # # ################### # # ##### ################# ### ### ### #
   #   # #   #   #   # # #     # #   #   # #       #       # #         # #           #   #   #   # #
 ### ### ##### ####### # # ##### ####### # # ##### # ####### ######### # # ######### ### ### ### # #
   # #   #     #       # # #     #         # #       #     #   #     #   #         #     #   #   # #
## # # ### ##### ####### # # ### # ######### # ######### ##### # # ##### ######### ####### ### # # #
   # # #   #     #     #   # #   # #     #   # #       # #       # #   # #       #       #   # # # #
 ### # ### # ##### ### ##### # ### ##### # ##### ##### # # ######### # # # ### # ####### ### # # # #
 #       # # #   #   # #     # # # #   # #       #   # # # #   #   # # # #   # # #     #   # # # # #
 ####### # # # # ### # # ##### # # # # # ######### # # # # # # # # # # # ### # ### # ##### # # # # #
       #   # # #   # # # #     # #   # #       #   # # #   # # # #   #   #   #   # #     # #   # # #
 ##### ##### # ### # ### # ##### ##### ####### # # ### # ##### # ########### ### # ##### # # ##### #
 # #   #   #   # # # #   #     #     #       #   # #   #       #     #     #   #   #   # # # #     #
 # # ### # ##### # # # ####### # ### ####### # ### # ############### # ### ### ##### ### # ### #####
   #   # #   #     # #   #   # #   #       # # #   #               #   # #   #   #   #   #   #   # #
## ### # ### # ##### ### # # # ### ######### # # # ############# ####### ### ### # ### ##### ### # #
 # #   # # #   #   #   #   # #   # #         # # #     #       #             #   # #   #     #   # #
 # # ### # ##### # ### ##### ### # # ######### # ##### # ####################### # # # # ### # ### #
   #   #       # # #       # #     # #       # #   #   #         #   #   #     #   # # # #   # #   #
 ##### ####### # # # ####### ##### # ##### ### ### # ### ##### # # # # # ### # ### # ### ##### ### #
   #   #   #   # # #     #   #   # #     #       # # # #     # # # #   #   # #   # # #   #     #   #
 ### # # # # ### # # ### # # # # ####### ####### # # # # ##### # # ####### # ### ### # ### ##### # #
 #   #   # # #   # #   # # # # #   #   # #   #   # # #   #     #   #   #   # # #     # #   #     # #
 # ######### ### # ##### # ### ### # # # # # ##### # ##### ######### # # ### # ##### # # ### ##### #
 #               #       #       #   #     #       #       #         #       #       #       #     #
