####################################################################################################
# #           #     # #     #       #       #             #       #       #       #       #         
# # ####### # # ### # # ### # ##### # # ### ### ####### ### # ### # ##### # # ### # ####### ##### # 
#     #     #   # #   # #   # #   # # # #     #       #     #   # #   # #   #   # #   #     # #   # 
####### ######### # ### # ### # # # # # ##### ####### ####### # # ### # ####### # ### # ##### # ### 
#   #   #           #   #     # # # # #   # #       # #     # # #   #     #     #   #   #   # #   # 
# # # ############### ######### ### # ### # ####### # # ### # # ### ####### ####### # ### # # ### # 
# #   #         #   # #       #   # #   # #         # # # # # # #     #     #       #     #   #   # 
# ### # ####### # # # # ####### # # ##### # ########### # # ### ##### # ##### ############### # ####
# # # #     #   # # # # #       #   #   # #         #   # #   #     #   #     #   # #       # #     
# # # ##### # ### # # # # ####### ### # # ######### # ### ### ### # ##### ##### # # # ### ### ##### 
# # # # #   #     #   # # #     # #   # # #     #   #   #   #   # # #   #     # # #     #     #   # 
# # # # # ############# # # ### # ### # # # ### # ##### # ##### ### # # ##### # # ##### ##### ### # 
# #     #         # #     #   # #     # # #   # # #     # #   #   # # #     # # # #   # #   #     # 
# ##### ######### # # ##### ### ####### # # # ### # ##### # # ### # # ##### # # # # # ### # # ##### 
#     # #     #   #   #   # #   #     #   # #     #   #     #   # # # #     #   #   #     # # #     
# ### # # ##### ####### # # # ### ### ##### ####### # # ##### ### # # # ####### ########### ### ### 
# #   #   #     #       #   #     # # #     #   #   # # #   # #   # # #     #   #         #     #   
### ##### # # ### ################# # ##### # # # ### # # # # # ### # ####### ### ####### ####### ##
#   #   # # # #   # #         #     #     # # # #   # # # # #       # #     # #   #   # #   #   # # 
# ### ### # ### ### # # ### ### # ####### # # # ##### # # ########### # ### # # ### # # ### # # # # 
# #   #   #     #   # #   # #   #       # #   #       # # #     #   #     #   #     # #   # # # #   
# ### # ######### # # ### # # ##### ### # ############# # # ### # # # ############### ### # ### ### 
# #   # # #       #     # # # #     # # #       #         #   #   # # # #           # #   #   #     
# # ### # # ########### # # # # ##### # ####### ############# ##### # # # ####### ### # # ### ##### 
# #       # #   #   #   # # # #     #   #     #             #   #   # # #     # #       #   #     # 
# ####### # # # # # ### # ### ##### ##### ### ############# ### # ### # ##### # ################# # 
#     #   #   # # #   # # #   #   #     # # #           # #     # #     #       #   #             # 
# ### ######### # ### ### # ### # ##### # # ######### # # ####### ### ### ####### # # ############# 
#   #   #       #   # #   #   # #     #     #       # #     #   #   # #   # #   # #   #       #   # 
### ### # ######### # # ##### # ##### ####### ##### # ##### # # ### ### ### # # # ##### # ##### # # 
# #   #   #       # # #     # # #   #   #     #       #   #   #   #   # #   # # # #     #   #   #   
# ### ##### ### ### # ### # # ### # ### # ############# # ####### ### # # ### # # # ####### # ######
#   #   #     # #   #   # #   #   #   # #   #   #       #   #   #   #   # #   #   # #     # #   #   
# # ### ##### # # ##### # ##### ##### # ### # # # ######### # # ### ##### # ####### # # ### ### # # 
# #   #   #   # # #     # #   #   #   #   #   # # #       # # #   #   #   # # #     # #   #   #   # 
# ####### # ### # # ##### # # ### # ### ####### # ### # # # ### # ### # ### # # ##### ### # # ##### 
# #     # # #   # #   #   # #   # #   #     #   #   # # # #   # #   # #   # #   #   # #   # #   #   
# # ### # # # ### ### ### # ### # ### ### # # ##### ### # ### # ### # ### # # ### # # # # # ### # ##
# #   #   # # #   #     #   # # #   #   # # #     # #   #   # #   #     # # # #   # # # # #   # #   
# ### ##### # # ####### ##### # ### ### # # ### # # # ####### ######### # # # ### # # # ##### # ### 
#     #     # #       #   #     #   #   # #   # # # #       #         # # # #   # #   #     # # #   
# ##### ####### ##### ### ##### # ### ##### ### # # # ##### ######### # # # ### ##### ##### # ### ##
# #     #     #     # # #     #   #         #   # # # #   #     #     #   #   #     # #     #     # 
# # # ### ### ####### # ##### ####### ####### ##### ### # # # ### ####### ### ##### # # ########### 
# # # #   # # #     # #     #       # #   #   #   # #   #   # #   #   #     #   # # # #             
# # # # ### # # ### # ### # ####### ### # # ### # # # ######### ### # ##### ### # # ####### ##### # 
# # # #   # #   # # #   # #       #     #   #   #   #         #   # #   #   # # #         # #   # # 
# # # ### # ##### # # # ##### ######### ##### ####### ####### ### # ### ### # # ######### # ### # # 
#   # #   #       # # #     #         # #     #     #     # #     # # #   #   #   #       #     # # 
##### # ####### ### ####### ####### ### # ##### ### ##### # ####### # ### ####### # ########### # ##
#   # #       # #           #     # #   # #   #   #     # #   #     #   # #       #   #       # #   
# ### ####### # # ##### ##### ### # # ### # # ### ##### # ### # # ##### # # ######### # ##### # ### 
# #   #   #   #   #   # #     #   #     # # #   # # #   #   #   # #     #   # #     # # # #   # #   
# # ##### # ####### # # # ##### ####### # # # ### # # ##### # ### # ######### # # # # # # # ##### # 
#   #   # # #       # # #   # #       # # # # #     #       # #   # #       #   # # # # #         # 
# ### # # # # ####### ##### # ####### ### # ### ########### ### ### # ### # ##### # # # ########### 
#   # # # # # #     # #   # #       # #   #     #     #   #     # #     # #   #   # # #     # #     
### # # # # # ### ### # # # ##### ### # ######### ### # # ####### # ##### ### # ### # ### # # # ####
# # # #   # #   #   #   #   #     #   # #       # # #   # #       # #   #   #   #   #   # # # #   # 
# # # ##### ### ### ######### ##### ### # ##### # # ##### ### ##### # # # # ##### ##### # # # ### # 
# # #     #   #   #         # #     #   # #   #   #   #   #S# #   # # # # #   # #   #   # # #       
# # ##### ### ### ##### # # # # ### # ### # # ##### ### #E# # # # # # # # ### # ### # ##### ####### 
# #     # #     # #   # # #   #   # #     # #   #   #   # # #   #   # # # #   #     #     #       # 
# ##### # # ### # # # # # ### ### ########### # ### # ##### ##### ### # ### ### ######### ####### # 
#     # # #   # #   # # # #   # #         #   #     #     #     # #   # #   #     #     # #       # 
# # ### # ### ####### # # # ### ### ##### # ### ######### ##### # # ### # ### ##### # ### # ########
# #     #   #   #   # # # # #     #   #   #   # #       #       # # #     #   #     #   # # #       
# ####### # ### # # # # # # # ####### # ### # ### ##### ######### # ####### ### ####### # # # ##### 
#     #   # #   # #   # # # # #   #   # #   #     #   #   #       #   #       # #       # # #   #   
##### # ### # ### ####### # # # # # ### ######### # # ### # ######### # ####### # ####### # ### # ##
#   #   # # #     #   #   #   # #   #   #       #   # #   # # #       # #       # #       #   # #   
# # ##### # ####### # # # ##### ##### ### ##### ####### ### # # ######### ####### # ####### # # ### 
# # #     #   #   # # # # #   #   # # #     #           #     #   #     #     #   #       # #   # # 
# # # ### ### # # # # # ### # ### # # ##### ########### # ####### # ### ##### # ######### # ##### # 
# #   #     # # # # #   #   #   # # #     # #   #       # #       #   #   #   #   #       #     # # 
# ##### ##### # # # ##### ##### # # ##### # # # # ####### # ##### # ### ### ##### # ########### # # 
#   #   #   #   # # #     #   # # #     # #   # #     #   #     # # #   #   #   # # # #           # 
# # ##### # ##### # # ##### # # # # ### # ##### ##### # ####### ### # ### ##### # # # # ########### 
# #       #   # #   #     # # #   # #   #       #   # #     # #   # #     #     #   # # #   #   #   
##### ##### # # ### ##### ### ####### ########### # # ##### # ### # ####### ### ##### # # # ### # # 
#   # #   # #   #       #   #       # #     #   # # #   # # #   #   #       #   # #     # #     # # 
# # ### # # ##### ######### ### # # # # ### # # # # ### # # ### ####### ##### ### # ##### ##### # # 
# #     # # #       #     #   # # # # # #   # # # #     # #     #       #       # # #   #   #   # # 
# ####### # # ####### ### ### # # # # # # ### # # ####### ##### # # # ######### # # # # ### # ### ##
#   #       # #       #       # # #   # #     #         # #     # # # #     #     #   #     #   #   
# # # ####### # ####### ####### # ##### ############### # # ##### # ### ### ######### ######### ### 
# # # #   #   # #       #   #   #       #         #     # #     # #   # # #         # #     #   #   
# # ### # # ### ######### # ######### ### ####### # ##### ##### # ### # # ####### ### # ### # ### # 
# #     #   # #         # #         # #     #   # #   #       # # #   #         #     # #   # #   # 
# ########### ######### # ######### ### ##### # # ### ### ##### # # # ######### ####### # ### # ### 
# #           #   #     # #     #   #   #     # # #       #     # # #       #   # #     #   # # #   
# ####### ### # ### ##### ### # # ### ### ##### # ####### # ##### # ######### ### # ####### # # # ##
#         # # #   # #   #     # #     #   #     #   # #   #   #   #   #       #   #     # # # # # # 
########### # ### # # # ####### ####### ### ##### # # # ##### ### ### # ######### ##### # # ### # # 
#             #   # # #       #       #   #   #   # #   #   #   #   #           #     # # #     # # 
# ############# ### # ##### # # ######### ### ##### ##### # ### # ############# # ### # # ####### # 
# #         #     # # #     # # #         #         #   # #   # # #   #       #   #   # #   #   # # 
# ####### # ##### # # # ####### # ################### # # ### # ### # # ##### ######### # ### # # # 
#         #       #   #         #                     #     #       #   #               #     #     
