     #           #     #     #   #         #   #         #         #           #   #   #     #     #
 ##### ######### # ### # ### # # # # ##### # # # # ##### # ######### ####### # # # # # # # ### ### #
   #   #     #   # #   #   #   #   # #     # # # # #     #                 # # # # # #   #     #   #
 # # ### ### # ### # # ### ######### # ##### ### # # ##### ########### ##### # # ### ########### # #
 #   #     # #   # # #   #   #   #   #   #       # # #   #   #       # #     # # #   #       #   # #
 ######### ##### # # ### ### # ### ##### ### ##### # ### # ### ##### ### ##### # # ##### ##### ### #
     #   #     #   # # # #   #   #     #   #   #   #   #   #   #   #     #     # # #   #   #   # # #
#### # # ### # ##### # # # ### # ##### ### # ### ##### ##### ### # ####### ##### # # # # # # ### # #
   #   #   # # #     # # # # # #     #   # # #   #   # #     #   #   #   #   #   # # # # # #   # # #
 # ####### # # # ##### # # # # # # ##### # ### ### # # # ####### ### ### ### # ### # # ### ### # # #
 #   #     # # #   #     # #   # # #     #     #   # # # #       # #     #   #   # # #     #   # # #
 ### ##### ### ### # ##### ### # ### ########### ### # # # ####### ### ### ##### # # ### ### ### # #
   #     #       # # #   #   # #   # #       #   #   #   #   #     #   #   #   #   #   # #   #   # #
 # ##### ####### # ### # ### # ### # ####### # # ########### # ##### ### ### # ### # # ### ### ### #
 #   #   #       #     #     # #   #       #   # #     #     # #     #   #   #   # # #   # #   #   #
#### # ############### ######### # ####### # ### # # # ### ### # ##### ### ##### # ##### # # # # ###
   # #               #   #   #   #   #     # # #   # #   # # #   #   #     #   # #       # # #   # #
 # # ############### ### # # # ####### ##### # ##### ### # # # ### ######### # # ####### # ##### # #
 # # #       #       #     #   #       # #     #     # #   # # #   #     #   # # #     # #     #   #
 # # ####### # ############### # ####### # ##### ##### ##### # # ### # # # # ### # ### ####### ### #
 # #       #             #     # #   #     # #   #   #   #   # #     # # # #       #   #     #   # #
 # ####### ############# ##### # ### # ##### # ### # # # # # # ####### ### ######### ### ### # # # #
 #       #       #     #     # #   # #     # #   # #   #   # # #       #       #   #     # # # # # #
 ####### ####### ### ####### # ### # ##### # ### # ##### ##### # ##### # ####### # ####### # # # ###
       #   #     #   #       #   # # #         # # #     #   #   # #   # # #     #   # #     # #   #
 ##### ### # ##### ### ####### ### # # ####### # # ####### # ##### # ### # # ####### # # ##### ### #
 #   #   #   #               # #   #   #   # # # #   #     #           #   #       # # # #   # # # #
 ### ### ################### ### ### ### # # # # # # # ########### ##### ##### ##### # # # ### # # #
 #     #     #             #   # #     # # # # # # #   #         # #     #     #     # # #       # #
 # ### ##### # ########### ### # ##### # # # # # # ##### ####### # # ##### ##### ##### # # ##### # #
 # #       #   #         # #   #   #   # # # # # # #     #     # # #     #     #   #   # # #   # # #
 # ####### ######### ### # # ### # ##### # # # # # # ##### ### # ##### ####### ### # ### ### # ### #
 #   #   #           #   # # #   #   #   # #   # # #   #   #   #       #       # # #         #     #
 ### # # ############# ### # ####### # ### ##### # ### # # ### ######### ####### # ############### #
     # #       #         # #       # #   #     # # #   # #   # #   #   #         #   #     #     # #
############## # ######### # ##### # ### ##### # ### ##### # # # ### # ######### ### # ### ##### # #
               # # #       # #   #     #   # # # #       # # #   #   #         # #   # # # #     # #
 ### ######### # # # ######### # ######### # # # # ##### ### ### # ####### ### # # ### # # # ##### #
 #   #       # #   #     #     #             # #   #   #     #   # #     #   # # #       # #       #
## ### ### ### ### ##### # ############### ### ##### # ####### ### # # ##### ### ######### # ##### #
   #   # #     # #     #   #     #   #   # #   #   # # # #   # #   # #     # #   #      S# # #   # #
 ### ### ####### ##### ##### ### # # # # ### ### # # # # # # # # ####### # # # ### ####### # # # # #
   #   #             # #     #   # #   #     #   #   # #   # # # #       # # #   #   #     # # # # #
## ### # ##### ####### # ####### # ##### ##### ####### ### # # # # ####### # # ##### # ##### # # # #
   #   # #     #       #       #   #   # #     #     #   # # # #   #     # # # #     # #     # # # #
 ### ### # ##### ############# # ### # ### ##### ##### # ### # ####### ### # # # ##### # ##### # # #
 #       #     #   #   #     # # #   #     #     #   # #   # #   #   # #   # # #     # #   #   # # #
 ############# ### # # ### ### # # ########### # # # ##### # ### # # # # ### # ##### # ##### ### ###
   # #           #   #   #   # # #   #         # # #       #   #   #   #   #     #   #       # #   #
## # # ################# ### # # ### # # ######### ########### ####### ### ####### ##### ##### ### #
   #   #         #     # #   # #   # # # #   #   #   # #           #   #   #   #   #   #     # #   #
 ####### ####### # ### # # ### # ### ### # # # # # # # # # ### ##### ### ### # # ### # ##### # # ###
   #     #   # #   # # #   #   # #   #   # #   # # # # # #   # #   #   #   # # # # E # #   #   #   #
 # # ##### # # ##### # ### # ##### ### ### ##### ### # # ### ### # ### ### ### # ### # # # ### ### #
 # # #     #     #   #     # #   # #   #   #         # #   #   # #   # # #     #     # # # # # #   #
## # ### ####### # # ####### # # # ### # ############# # ##### # ### # # ##### ####### # # # # # ###
   #     # #   #   # #     # # # #     #       # #       #     # #   # #   # #     # #   # #   # # #
 ######### # # ##### ### ### # # ##### ####### # # ####### ### # # # # # # # ##### # ##### ##### # #
 #       #   #     #     #   # #   #   #   #   #   #       #   # # # #   #   #   # #   #   #     # #
 # # ##### ##### ####### # # # ### # ### # # ### ### ####### ### # # ##### ### # # # ### ### ##### #
 # #     # #   # #     # # # #   # # #   # # # # # #     #   #   # #     # #   #   #   #     #     #
 # ##### # # # # # # ### # ##### # # ##### # # # # ##### ##### ### ##### # # ####### # ####### ### #
 # #   # #   # #   #   # #       #   #   # # #   #     #   #   # #   #   # # #   #   #         # # #
 # # # # ### ######### # ############# # # # # ### ### ### # ### ### ##### # # # ##### ######### # #
   # # # #   #       # # #         #   #   # # #   #     #   #     #       #   #     #     #     # #
 ### # # # ### ##### # # # ### ##### # ### # # # ### ### ######### ################# ##### ##### # #
 #   # #   #   #     # # # #   #     # #   # # #   # # #   #       #     #         #     #   #   # #
 ### # ##### ####### # # # # # # ##### ##### # ##### # ### ### ### # ### # ### ######### ### # ### #
   # #     #       #   # # # # # #   # #     #       #   #     #   # # # #   #       #   #   # #   #
## ##### ######### ##### ### ### ### # # ############# # ####### ### # # ### ####### # ### ### # ###
 # #     #         #   #   #         # #   #   #       #   #     #   # #   #       #   # #     #   #
 # # ##### ##### ### # ### # ######### ### # # # ### ##### # ##### ### ### ####### ##### ##### ### #
     #   # #   # #   #     #   #     #   #   # # #   # #   #   #   # #     #     # # #       # #   #
 ##### # # # # # # ############# ### # ####### # # ### # ##### ### # # ##### ### # # # ### # # # ###
 #   # # #   # # #   #         #   #   #     # # # #       #   #   # # #     # # # #     # # # #   #
## # # # ##### ##### ### ##### ### ##### ### # # # ####### # ### ### # # ##### # # ####### ### ### #
   #   #     #     # #   #   #   #     # # #   # # #     # #     #     # #     # #       #     #   #
 ########### ### ### # ### ##### ##### # # ####### # ### # ####### ##### ##### # ####### # ##### ###
 #             #   # # #         #     # #         #   # #   # #   #   #     #   #     # # #   #   #
 ############# ### # # ### ##### # ##### # ##### ##### # ### # # ### # ### # ##### # ### # # # ### #
 #   #     # #     # #   # #   #   #     # #   # #     # #     #     #   # # #     #   # # # #   # #
 # # # ### # # ##### # # ### # # ### ##### # # ### ##### ############### ### # ####### # ### ### # #
   # # # # #   #   # # #     # # #   # #     #   #   # #         #     # #   # #     #   #   #     #
 ### # # # ##### # # # ####### # # ### # ####### ### # ######### # ### # # ### ### # ##### # ##### #
 # #     #   #   #   #     #   # #   #     #   #   #   #   #   #   # #   #   #   # #       # #   # #
 # ######### # ########### # ### ### ##### # # ### ### # # # # ##### ####### ### ####### ##### # ###
       #   # #   #     #   #   #   #     # # #   #   # # #   #   #         #   #     #   #     #   #
######## # # ### ### # ####### ######### # # ####### # ### ##### # # ##### # ####### # ### ####### #
   #     #     #     # #     #         # #   #       #   #     #   # #   # # #     # # #   #     # #
 # # ##### ########### # ### # ##### # # ### # # ####### ########### # ### # # ### # # # ##### # # #
 #   #   # #           #   # # #     # #   # # # #               #   #     #   #   # #   #     # # #
 ##### ### # ########### # # ### ######### # # ### ############# # ### ######### # # ### ### # ### #
   #       # #           # #     #         # # #   #     #   #   # #     #       # #   #   # # #   #
## ####### # ### ######### ####### ######### # # ### # ### # ### # ##### # ########### ### # # # ###
   #     # #   # #   #   #       # #         # # #   # #   #   #   #   #   #   #     #   #   # #   #
 ### ### ##### # # # # # ####### # ########### # # ### # ##### ##### # ### # # # ### ### ##### ### #
     # # #   # # # #   #     #   #       #   #     #   #   # # #   # #   # # # # # #   # #   # #   #
 ##### # # # # ### ######### # # ####### # # ############# # # # # # ### ### # # # # ### # # ### # #
       #   #       #           #       #   #                 #   #     #     #     #       #     # #
####################################################################################################
