#   #   #       #             
# ### # # ##### # ########### 
#     #   #   #   #       #   
##### ####### ##### ##### # ##
#   #   #   #   #   #   # #   
# # ### # # # # # # # # # ### 
# #   #   #   # # # # # #     
# ### ######### # # # # ##### 
# #     #       # # # #     # 
# ##### # ####### # # ##### # 
#     # #     #   # #   # # # 
# ### # ##### # ### ### #E# # 
# # # # #     #   #   #   # # 
# # # # ####### # ####### # # 
#   # #       # #       # # # 
### # ####### # ##### # # # ##
#   # #     # # #     # # #   
# ### ### ### # # ### ### ### 
#   #   #   # # # #   #   # #S
# ##### ### # ### ### # ### ##
# #     #   #   #   # #       
# # ##### ##### ### # ####### 
# # # #             # # #     
# # # # ############# # # ####
# # #     #   #         # #   
# # ####### # ######### # # # 
# #   #     # #   #   # # # # 
# ### # ##### # # # # ### ### 
#   #       #   #   #         
##############################
