#   #     #   #     
# # # ### # ### # ##
# #   # #   #   #   
# ##### # ### ##### 
#   #     #   #     
# # # ##### ### ### 
# # #     #   #   # 
# # ####### ##### # 
# #         #     # 
# ##### ##### ##### 
# #   #     # #     
# # # ##### # ##### 
# #S#     # #     # 
# ####### ### ### #E
#     # #   #   # # 
##### # ### ##### ##
# #   #   # #   #   
# # ##### # # # ### 
#         #   #     
####################
