####################################################################################################
#           #   #         #   #       #           #       #   #  S#   #                     #       
# ######### # # # ##### # # # # # ### # ### ####### ##### # # # ### # # ################# # ##### # 
# #       #   # #   # # # # #   #   #   #   #       #   # # #   #   # #       #           # #     # 
# ### ######### ### # # ### ####### # ##### # ######### # # ####### # ####### # ########### # ##### 
#   #   #       # #   #     # #     # #   # # #         # # #     # #       # #   #   #   # # #   # 
### # # # ##### # ### ####### # ##### # # ### # # ##### # # ### # # ####### ### # # # # # # # # # # 
#   # # # #   #     #   #     #   #   # #   # # # #     #   #   #   #   # #   # # # # # #   # # # # 
# ##### # # # ##### ### ### # ### # ### ### # ### # ######### ##### # # # ### # # # ### ##### # # # 
#       # # # #   #   # #   # # # #   #   # # #   #   #     #   #   # # #     # # #   #   #   # # # 
######### # # # # ### # # ### # # ### ### # # # ##### # ##### # ##### # ### ##### ### ### # ### ### 
#     #   # # # #   # # # # # # #   # #   #   #   # E #   #   #       #   #     # #     # # #       
# ### # # # # # ### ### # # # # ### ### ####### # ### # # # ############# ##### # # ##### # # ######
# #     # # # # # #     # #       # #   #     # #   # # # #   #     #   #   # #   #         #   #   
# # ####### # # # ####### ####### # # ### ### ##### # ### ### ##### # # ### # ##### ########### # ##
# #   #     #   #       #       # # #     # #     # #   #         # # # #   #     # #   #   #   #   
# ##### ######### ### # ### ### # # ####### ##### # ### ######### # # # # ##### ### # # # # # ##### 
#       #   #   # # # #   #   # # #     #     #   # # # #   #       # # #     #     # # # # #       
# ####### # # # # # # ### ##### # ##### # # ### ### # # # # ######### # # ### ####### # ### ####### 
#         #   # #   # # #     # # #   # # #     #   # # # #           # #   #         #   #       # 
############### # ### # ##### # # # ### # ####### ### # # ############# ### ############# ####### # 
#         # #   # #   #       # #   #   #         # #   #   #         #   #             #   #   # # 
####### # # # ##### ### ####### ##### # ########### # ##### ##### ####### ############# ### # # # # 
#       #   #     # #   #     # #     #     #   #   #     #     #       #     #     # # # # # #   # 
# # ####### ##### # # ### ### # # ##### ##### # # # ##### ##### # ### ####### # ### # # # # # ##### 
# # #     # #   # # # #   #     # #   # #     #   #     # #   # # # #       # # #   # #   # #       
# ### ### # # # # # # # ##### ### # # # # ####### ##### # # # # # # ##### ### # ### # # ### # ######
#   # # # # # # #   # # #   # #   # #   # #     # #     #   #   #       # #   #   # #   #   # #     
# # # # # # ### ##### # # # ### ### ##### # ### ### ##################### # ### # # # ### ### # ### 
# #   # # #     #     #   #   # #     #   # #   #   #                   # #   # # # #   # # #   #   
# ##### # ##### # ##### ##### # ##### # ### ### # ### # ##### ######### # ### ### # ##### # ##### ##
#       #   #   # #     #     #   # # #   #   #   #   # #   # #   #       #   #   # #     #     # # 
# ######### ##### ####### ### ### # # ### ### ##### ### ### # # # ######### ### ### # ##### ##### # 
# #         #   # #     #   # #   # #   #   #       # #   # # # #         #   #   #   #   #       # 
# # ######### # # # ### ### # # ### ### ### ######### ### # # # ######### ### ### ##### ### ####### 
# # #         #   # #   #   # #   #   # # #   #         # #   # #       #   #     #     #   #       
# # # ############# # ### ####### # ### # ### # ##### ### ##### # ##### # ########### # # ####### ##
# # # #     #       # #         # #     #   # # #     #   #   #   # #   #             # # #     #   
# # # # ### ##### ### ####### # # ### ##### # ### ##### # # # ##### # ##### ############# # # # ### 
# # #   #   #     #       #   # #   #       # #   #     # # #   #   # # #   #     #       # # #   # 
# # ##### ### ########### # ### ### ####### # # # # ####### ### # # # # # ### ### # ######### ### # 
# # #     #   #       # #   # #   #     #   # # # #     #     #   # # # #   #   #   #       #   # # 
# # # ##### ### ##### # ##### ### ##### ##### # # ##### # ######### # # ### ### ##### ### # ### # # 
# # #     #     #   # #       #   #   # #     # #   #   # #         # #   #     #   #   # #   # # # 
# # ##### # ##### # # ### ### # ### # # # ##### ### # # # # # ##### # ### ####### ##### # ### # # # 
# #   #   # #     # #   #   # # #   #   # #     # # # # # # # #   # # #       #   #     #   #   #   
# ### # ### # ##### ### ##### # # # ##### # # ### # # ### # # # # ### # ####### # # ####### ####### 
# #   # #   # #       #     # # # # #     # # # #   #     # # # #     #         #   #   # #   #   # 
# # # # # ##### # ##### ### # # # ### ##### # # # ######### # # ########### ######### # # ### # # ##
# # # # # #     # #   # #   #   #   #   #   # #   #       # # #   #       # #         #   #   # #   
# # ### # # ##### # # ### # ####### ### # ### # ### ##### # ##### # # ### # ####### # ##### ### ### 
# #     #   #     # #     # #       #   #   # #   #     # #       # # #   #         # #   #     #   
# ######### ####### ####### # ### ### ##### # ### ### # ############# # ##### ####### # # ### ### # 
#   #   #   #     #     #   # # # #   #     #   #   # #       #       # #   # #   #   # #   # #   # 
### ### # ### ### ##### ##### # # # ##### ##### ### ### ##### # ### ### ### # # # # ### ### ### ### 
# #   # # #   #         #   # #   #     #   #   # #   # #     #   # #   #   # # # #   #   #   # #   
# ### # # # ### ######### # # ### ##### ### # ### ### ### ##### ### # ### ### # # ####### ### # ####
#   # #   # # # #   #   # # #   # #   #   # # #     #   #   #   #   #   #     # #       # #   #     
### # # ### # # # # # # # # ### # # # ### # # ##### ### # # # ### ##### ### ### ####### # # ####### 
#   # #   # #   # # # #   #   # #   # #   # #     #     # #   # #   #     # #   #     # # # #   #   
# # # ##### # ### # # ##### ### ##### # ### ##### ##### ### ### ### ##### ### ### ### # # # # # # # 
# # #     # # #   # # #   #   #   #   #   #     # #   #   #     # #   # #   #   #   # #   # # #   # 
# # ##### # # # ### # ### ### ### # ##### ##### # # # ### ##### # ### # ### # # # # ####### # ##### 
# # #   # # # #   #       #     # #     # #   # #   #   # # #   #   # #     # # # #           # #   
# # ### # # ##### ######### ##### ##### # # # ######### # # # ### # # ### ### # ##### ######### # ##
# #     # #         #       #     # #   # # # #         # # #     # #   #   # #     # #   #   #   # 
# ##### # ### ####### ##### # ##### # ### # # # ######### # ####### ### ### ### ### ### # # # # ### 
#     # #   # #       # #   #   #       #   #   # #     # #       #   #   #   #   #     # # # # #   
##### # ### ### ####### # ##### # ############### # ### # # ##### # ##### ### ########### # ### ### 
#   # #   # #   #     #   # #   #     #           # # #   # # #   # #     # # #   #       #   #     
# # # ##### # ### ### # ### # ####### # ### # ##### # ##### # # ### # ##### # # # # ####### # ##### 
# #   #   #   # # #   # #   #     #   # #   # #     #   #   # #   # # #         # #     #   #     # 
# ##### # ##### # # ### # # ##### ### # # ##### ####### # ### ### # # ########### ##### ##### ##### 
# #   # #         #   # # #   # #   # # # #   #       # # #   #   # #       #     #   # #   # #     
# # # # ############# # # ### # ### # # # # # ####### # # ### # # # ####### # ##### # # # # # # ####
#   #   #           # #   #       # # # #   #       # #       # # #   #     #       # #   # # #   # 
# ####### ### ####### # ########### ### ######### # # ####### # ### ### ############# ##### # ### # 
# # #     # #       #   #     #     #   #       # # #       # # #   #   #       #   #       #     # 
# # # ##### ####### ##### ### # # ### ### ####### # ####### # # # ### ##### ### # ########### ##### 
# # #       #     # #     #   # # #   #   #   #   # #       # #   #   #     #   #           # #     
# # ####### # ### # # # ##### # # # ### ### # # ##### ####### ##### ### ##### ##### ######### ### ##
# #         # # # # # # #   #   # # #   #   #   #   # #     #   #   #   #   # #     #       #   #   
# ##### ##### # # # # ### # ##### # # # # ##### # # # # ### ### # ### ### ### # ##### ##### ### ### 
#     # #     #   # #     # # #   # # # #   #   # #   #   #   # # #   #     #   #     #   #   # #   
##### # # ##### ### ####### # # ### # ##### ##### ####### ##### # ### ##### ### # ####### ### # # # 
#   # # # #   # #         # #     # #     #   #   #     # #     #   #     #   # #   #     #   # # # 
### # ### # # # # # ####### # ##### ### # ### # ##### # # # ####### # ### ### # ### # # ### # # # # 
#   #     # # # # #       # # #     #   # # #   #     # #     #     # # #   # # #   # #   # # # # # 
# ######### ### # ####### # ### ##### ### # ##### ##### ####### ##### # ### # # # ####### # # # # ##
#     #   #     #   #     #   # #   # #   #     #   #   #   #   #   # # #   #   #         # # # #   
### # # # # ####### # # ##### # # # # # ##### # # # ### # # # ### # # # # ############### # # # ### 
#   #   # # # #   # # # #   #   # #   #     # # # #   #   # # #   # #   #             #   # # #     
# ######### # # # # # ### # ##### ######### # ### ### ##### # # ### ### ######### ##### ### # ##### 
#       #   # # #   # #   #           #     # #   #   #   #   # #     #   #   # #       #   #     # 
# ##### # ### # ##### # ############# # ##### # ### ### ######### ### ### # # # ######### ### ##### 
# #     #   #   #   #     #           #   #   #   # #   #         #     #   #   #     # # #   #     
# # ### ### ### # ######### ############# # # ### # ### # ##### # ############# # ### # # ##### ####
# # #     #   #   #   #     #         #   # #     # #   #   # # # #       #   # # # # # # #     #   
# # ######### ##### # # ##### ### ##### ########### # ##### # # ### ##### # # # # # # # # # ####### 
# #                 #   #       #                   #         #         #   #     #     #           
