##############################
#   #   #                 #   
# # # # ######### ####### # # 
# # # #   #     #   #   #   # 
# # # ### # ### ### # # ##### 
# # # #   #   #   # # #   #   
# # # # ### # ### # # ### # ##
# # # #   # # #   #   # # #   
# # # ### # # ### ### # # ### 
# #   #   # #   #   #   # #   
# ##### ####### ### ##### ####
#   # #       #   #     # #   
# # # ####### ### ##### # # # 
# # #       # #   #   # # # # 
### # ##### # # ##### # # # # 
#   # # #   # #   #   #   # # 
# ### # # ### ### # ### ### # 
# #     # #   #   # #   #   # 
# # ##### # ### ### # ### ### 
# # #     # #   #     #   # # 
# # # ### # # ####### # ### # 
# # #   # #   #     # # #   # 
# # ### ### ### ### # # # ### 
# #   #     #   # # # # #     
# ########### ###E# ### # ####
# #       #   #   #S#   # #   
# # ##### # ##### ### ### # ##
#   #   # #           # # #   
# ##### # ############# # ### 
#       #                     
