 #     #       #       #               # #       #         #     #       #       #           #     #
 # ### # # ### # ### # # ######### ### # # # ### # ##### # # ### # ### ### ##### # ####### # ### # #
 #   #   # #   #   # # # #   #     #   # # #   # #   #   # #   #   # #     # #   # #     # #     # #
 ### ##### ####### # # ### # # ##### ### # ### ##### # ####### ##### ####### # ### # ### # ####### #
 #   #   # #   #   # # #   # # #   #     # # #     # #       #       # #     #     #   # # #       #
 # ### # # # # # ### # # ### # # ####### # # ##### # ##### # ####### # # ### ####### # # # ##### ###
     # #   # #   # # #   #   # # #     # # #   #   # #     #     #   #     #       # # # #     # # #
 ##### # ### ##### # ##### ### # # # ### # # # # ### # ####### ### ####### ##### # ### # ##### # # #
 # #   # #   #     # #         # # #     # # # # #   #       # #   #     # #     #     # # #   #   #
 # # # ### ####### # ########### # ####### # ### # ######### ### ### # # # # ########### # # # #####
 # # # #   #     # #         #   # #     # #   # #   #     # #   #   # # # # #         # # # # #   #
 # # ### ### ### # ######### ### # # ##### # # # ### # ### # # ### ### # ### # ##### # # # # ### # #
   #     #   #     #       #   # # #   #   # # #   # # #   #   #   #   # #   # #     # # # #     # #
## ####### # ####### ##### ### # # ### # ##### # ### # ######### ### ### # ### # ### ### # ##### # #
 # #       #       #   #     # #       # #     #   # #         # # #   #   # # # #   #   # #   # # #
 # ######### ##### ### ##### # ##### ### # ### ### # ####### ### # ### ##### # # ### # ### # # ### #
 # #       #   # #   #   #     #   # #   # #   #   #     #   #       # #   # # #   # # #   # #   # #
 # # ##### ### # # ##### # ##### # ### ### ### # ####### # ### ####### # # # # ### ### ### # ### # #
 # # #   #   #   #     # #   #   #   # #     # #     #   #     #     #   # # #   #     #   #   #   #
 # # ### ### ### ### ### ##### ##### # ##### # ##### # ######### ### # ### # ### ####### # ### #####
 # #   # #   #   # #   #     # #   # #       #   #   # #         # # #   # # #   #       #   # #   #
 # ### # # ### ### ### ##### # # ### ####### ##### ### # # ####### # ##### # # ##### ### ##### # # #
 # #   #   #   #     #   #   # # #   #   #   #   # #   # # #       #   #   # # #     #   #     # # #
 # # ### ### ### ### # ### ### # # # # ### ### # # # ##### # ##### ### # ### # # ######### ##### # #
 # # #   #   #     # #   #   #   # #   #   # # #   #       #   # # #     #       #   #   #   #   # #
 # # ### # ######### ### ### ### # # ### ### # ### ########### # # # ############# # # # # # ### ###
 # #   # #         # #     #   # # # #       #   # # #       # # #   #       #   # #   # # #   #   #
 # # # # ######### # # ##### ### # ### ######### # # # ### # # # ##### ##### # # # ##### ##### # # #
   # # # #     #   # #     #     #     #         # #     # # # #     #   # #   #   # #   #   # # # #
 ##### # # ### # ### ##### ############# ######### # ##### ### # ### ### # ### ##### # ### # # # # #
   #   # # # # # #     # #     #   #   # # #       #   #   #   #   # #   #     #   #     # # # # # #
## # ### # # # # # ### # ### # ### # # # # # ########### ### ##### ### ### ##### # ##### # # # # # #
 #   # # #   #     #     #   # #   # # # # # #           #   #     #   #       # #     #   #   # # #
 ##### # ### ########### # ### # # # # # # # # ######### # ### # ### ### ####### ##### ########### #
       # # #   #   #   # # # #   # # #   # # #   #       #     # #   #   #   #   # #   #           #
 ### ### # # ### # # # ### # # ##### ##### # # # ##### ### ####### ####### # # ### # ####### #######
 # #     #   #   #   #   # # # #   # # #   # # # #   #   # #       #       # # #   # #     #   #   #
 # ########### ######### # # # # # # # # # # # # # # ### # # ####### ####### # # # # # ### # # # # #
 #     #       #       #   #   # #   # # #   # #   # # # # #   #   # #     #   # # # #   # # #   # #
 # ### # ####### ########### ### ##### # ########### # # # ### # # # ### # ####### # ### # ####### #
 #   #   #   #             # #   #     #             # # #   #   #   #   #   #     #     #   #     #
 ### ##### ### ########### # # ####### ############### # ### ######### ##### ### # ######### # #####
     #     #     #       #   # #     # #         #     #   #   #       #   #     #   #       # #   #
###### ##### ##### ##### ### # # ### # # ##### # ### # ### ### ### ##### # ######### # ####### # # #
     #     # #     #   #   # # #   # #       # #     #   #   #     #   # #     #     # #   #     # #
 # # # ### # # ##### # ### ### ### # ####### # # ########### ####### ### ##### # ##### # # # ##### #
 # # #   #   #   #   #   #   # #   #   #     # # #     #     #       #   #   #   #     # #   #     #
## # ### ####### # ##### ### # # ##### # ##### # # ### # ##### ### # # ### # ##### ####### ### ### #
   # # #     # # # #   #   #   # #   # #   #   # #   #   #       # # # # # #     # #S    # # # # # #
 ### # ##### # # # # # # # # ### # ### ### # ####### ##### ####### # # # # ### ### ##### # # # # # #
 # #     #   # #   # # # # # #   #   # #   #     #   # #   #   #   # # #     #   #     # #   # # # #
 # ##### # ### ##### # # # # # ##### # # ####### # ### # ### # # ### # ######### ### ### ##### # # #
 #   #   #   #     # # # # # # #     # #       #       #     # # #   #   #     # #   #   #     #   #
 # ### ##### # ### # # ### # # ### # # ##### ######### ####### # ####### # ### # # # # ### ##### ###
 #       # # #   # # #     # # #   # #     # #       #   #     #           #     # # # #   #     # #
 ####### # # # # # # ######### # ######### ### ##### ##### ####################### ### # # ### ### #
     #   # # # # # # #   #     # #       #     # #   #     #         #     #       #   # #   #   # #
 ### # ### # ### ### # # # ##### # ##### ####### # ### ##### # ####### ### # ##### # ####### ### # #
   # #     #   #   #   # # #     # #   #         #     #   # #   #     #   # #   # # # E   #   #   #
## # ##### ### # # ##### # # ##### ### ####### # ####### # # ### # ##### ### # # ### ### # # # ### #
 # #   #     # # #     #   #                 # # # #     # # # # # #         # #   #     # # # #   #
 # ### ####### ####### ######### ####### ##### # # # # ##### # # # ####### ### ### ####### ### # ###
   # #   #   #   #             #   #   # #     #   # #       # # #     #   #     #   #     #   #   #
 ### ### # # ### # ########### ##### # ### ####### # ######### # ##### ##### ##### # # ##### #######
   #   #   #     # #         # #     # #   #   #   # #         #     #       #     # #   #         #
## ### ########### # ##### ### # ##### # ### # ##### # # ##### ##### ######### ##### ### # ####### #
 # #   #           # #     #   #   #   # #   #   #   # #   #       #   #       #   # # # # #       #
 # # ### ##### ##### # ##### ### # # ### # ##### # ####### # ######### # ####### # # # # # # ##### #
   #     #     #   # # #     #   # #   #       #         # #   #     # #   #   # #     # # #     # #
 ### ##### ##### # # ### ######### ### ################# # ##### ### # ### # # ### ##### # ##### ###
 #   #   #     # #   #   #     #   #   #             #   # #     # # # #   # #   # #     #     #   #
 # ##### ##### # ##### ##### # # ### ### ########### # ### # ##### # # # ### ### # # ######### ### #
 #       #     # #     #     # # # #     # #   #     # #   # #         # #   # # # # #       # # # #
 ####### # ##### # ##### ##### # # ####### # # # ##### # # # ########### # ### # # # ### ### # # # #
 #     # # #       #     #       #     #     #   #   # # # #   #   #   #   #   # # #   # #   #   # #
 # ##### # # ####### ####### ##### ### # ########### # # ##### # # # # ##### ### ##### # # ##### # #
 #       # #     #   #     # #   #   # # #           # #     # # #   #     #   #       # #       # #
 ##### ### ##### # # # ### ### # ### # # # ##### # ### ##### # # ##### # ### # ############### ### #
 #   #   #   #   # #     #     # # # #   # #   # #       #   #   #   # # #   #               # #   #
 # # ### ### # ########### ##### # # ####### # # ####### # # ##### # ### # ############# ### ### # #
   # #     # # #         #     # # #         # #   #   #   #   #   #     #           #   #   #   # #
#### ### ### # ### ##### ##### # # ########### ##### # ####### # # ############# ##### ### ### ### #
   #   # #   #     #   # #   # # #         # #     # #       # # # #             #   #   # #   #   #
 # ### ### ######### # # # # # # # ####### # ##### # ####### # # ### ############# # # # # # ### ###
 #   # #   #   # #   #   # # # # # #       #     # # #       # #     #   #         # # # #   #   # #
 ### # # ### # # # ####### ### # # ##### ####### # # # ########### ##### # ######### ### ##### ### #
 #   #   #   #   #     #       # #     #     #   #   # #         #     # # #       #     #     #   #
 # ####### # ### ##### ##### ### ##### ##### # ####### # ####### ##### # # # ##### ####### ####### #
 # #       # #       #     #   # #   #   #   #   #   #   #     #     #   # # #   #   #     #     # #
## # ####### # ########### ### # # # ### ### ### # # ##### ### ##### ### # # # # # # # ##### # # # #
   #   # #   # #         #   # #   #   #   #     # # #       # #   # #   # # # #   # #   #   # # # #
 ##### # # ##### ### # ##### # ####### # # ##### # # # ##### # # # # ##### # # ######### ##### # # #
 #   # # # #     # # # #     #   # #   # # #   # # #     #   #   # # #     # #   #     #   #   #   #
 # # # # # # ##### # ### ####### # # ### # # # # # ####### # ####### # ##### ### # ### ### # ##### #
   #   # #   #     #   #     #   # # #   # # #   #     #   # #       # #     # #   #     #   # #   #
 ####### ##### # ##### ##### ### # # # ### # ######### # ##### ####### # ##### ##### ######### # ###
   #           #     #     #   #   # #   # #   #   #   # #     #       # #       # #   #       #   #
## ################# ##### ### ##### ### # ##### # # ### # ######### ### ##### # # ### # ##### ### #
                         #           #   #       #     #             #         #     #       #     #
####################################################################################################
