#   #         # #       #         #       #     #       #   #   # #     #   #       #     #     #   
# # # ####### # # ##### # # ##### # ##### # # # # ##### # # # # # # # # ### # # ### ### # ### ### # 
# # #   #   #   #     # # #     # # # #   # # #   #       #   # #   # # #   # # #       #   # #   # 
# # # # # # ### ##### # # ##### ### # # ### # ################# # ### # # ### # ########### # # ### 
# # # #   #   #   # # # #     #     # # #   #   #     #       # # #   # #   # #     #   #   #   #   
# # ######### ### # # # ##### ####### # # ##### # ### # ##### # ### ### # # # ##### # # # ####### # 
# #   #     #   #   # #       #   #   #   #     #   # # #   # #     # # # #     #   # # #         # 
# ### # ### ### ### # ######### # # # ##### ##### ### # # # # ####### # ##### ### ### # ########### 
# #   # # #     # # #   #   #   #   #     #       #   # # # #         #     # #   #   #     #   #   
# # ### # ####### # ### # # ### ######### ######### # ### # ### # ### ##### # # ### ### ### # # # ##
# #     #       #     #   # #   #     #   # #     # # #   #   # #   #     # # #   #   #   #   # #   
# ####### ### ### ######### # ##### # # ### # ### # # # ##### ##### ##### # # ### ####### ######### 
#   #       #     #         # #     # # #   #   #   # #     #   #   #     # #   # #     # #         
### # ########### # ######### ### ##### ### ### ########### ### # ### ##### ##### # ### # # ##### ##
#   #     #     # #   # #       #     #       #             #   # #   #   #     #   #   #   #   #   
# ##### ### ### ##### # # ##### # ### ####### ############### ### ##### # ##### ### # ### ### # ### 
#   #   #   # #       #       # #   #     #   #     #     #   #   #     #   # #   # #   # # # #   # 
# # ##### ### ############### # ### # ##### ### ##### ### # ### ### ##### # # ### # ### # # # ### # 
# #       # #               # # #   #     # # #       #   # #         #   #     # # #   #   # # # # 
# ######### # ####### ##### ### # ####### # # # ####### ### # ######### ####### # ### ##### # # # ##
#   #     # # #     # #   #     #     # #   #         # #   # #       # #       # #   #     # # #   
### # ### # # # # ### # # ########### # ########### ### # ##### ##### # ######### # ######### # ### 
#   #   # #   # # #   # #           # #           # #   #       # #   #             #             # 
# ##### # # ### ### ### # ##### ##### ### ####### ### ########### # ################# ############# 
#       # #     #   #   # #     #     #   #     #   #             #     #   #         #   #   #     
######### ##### # ##### # # ##### ##### ### # ##### # ####### # ####### # # # ######### # # # # ### 
# #       # #   #     # # # #     #     #   #     # #   #   # #     # #   # #         # # # #   # # 
# # ####### # ####### ### # # ##### ### # ##### ### ##### # ##### # # ##### ######### # ### ##### # 
# #       #       # #   # # # #   # #   #     # #   #     # #     #   #   #         # #   #     #   
# ####### ####### # ### # # # # ### # ######### # ### ##### # ####### # ######### ### # # ##### # ##
#   #   #     #   #   # # # # #     #     #   # # #   #   #   # #     # #       # #   # #   # # #   
# # # # ##### ### # # # # # # ### ####### # # # # # # # # ##### # ##### # ### # # # ##### # # # ####
# # # #     #   #   # # # # #   # #   #   # #   # # # # #     #   #   #   #   # #   #     #   # #   
# # # ##### ### ####### # ##### # # ### ### ##### ### # ### ### ### ### ### ######### ####### # # # 
# # #   #     #         # #     #   #   #             # #   #   #   #   #   #             #   #   # 
# ##### # ############### # ####### # # ############### # # # ### # # ### ### ########### ######### 
#       #               #   #     # # # #   #     #     # # #   # # # # #     #     #     #       # 
# ################### # # ##### ### # # # # # ### ####### ##### # # # # ######### # # ### # ##### # 
# #   #       #       # #     #     # # # #     # #       #   # # #   #           # # #   # #     # 
# # # # ##### # ####### ##### ### ### ### ####### # ##### # # # # ####### ########### # ### ### ### 
#   # #     # # # #       # #   #   #     #   #   # #     # #   #       #       #     #   #   #   # 
##### ##### # # # # ##### # ### ### ####### ### ### # ##### ########### # ##### # ### ####### ### # 
#   # #     # # #   #   #   # # #   #       #   #   #   # #     #   # # #     # # #   #       # # # 
# # # # # ##### ##### # ### # # # ##### ### # ### # ### # ##### # # # # ####### # ### # ####### # # 
# #   # # #   #       # #   # # #       # # # #   # #         # # # #           #   # # #       # # 
# ##### # # # ####### # # ### # ######### # # ### # ########### # # ########### ### ### ####### # # 
# #     # # # #     # # #     # #       #   #   # #           #   #     #     #   #   #       #     
# # # ##### # # ### ### ##### # # ##### # ##### # ########### ######### # ### ### ### ####### ######
# # # #   # #   #     # #     #   #   # #     # #       #   #         #   # # # #   # #     #   #   
# # # # # # # ####### # # ######### # # ####### ####### # # ##### ######### # # ### # # # ##### # # 
# # # # #   # #     #   #         # # # #       # #   # # #     #             #     #   #     #   # 
# # ### ##### # ### ########### ### # # # ####### # # # # ##### ######### ################# # ##### 
# #   #     # #   #       #   # #   # #   #     #   #   # #   #   #     #                 # #     # 
# ### ##### ##### ####### ### # # ### ####### ### ####### ### ### # ### ################# ### # ### 
# #     # #       #   # #   #   # # #         #   #     # #     #   #           #   #   #   # # #   
# # ### # ######### # # ### # ### # ### ### ### ### ##### # ####### ########### # # # # ### # # # ##
#   # #     #       #     # # #   #   # #   #   #   #     #         #   #     #   # # #   #   # #   
##### ##### ##### ######### # # ##### # # ### ### # # # ##### ####### # ##### ##### ##### ##### ### 
#   #   #         #       # # #       # # # #   # # # # #   # #   #   #     #   #   #   #       #   
### # # # ######### ##### # # ####### # # # ### # ### ### # # # # # ####### # # # ### # ####### # ##
#   # #   #       #     #   #   #     # #     # #   #   # # #   # #     #   # #       # #     # #   
# ### ##### ##### ##### ####### # ##### ####### # # ### # # ##### ##### # ############# # ### ##### 
#     #   # #   #       #       # #   #     #   # #   # # #   #     #   #         #   # # #         
# ##### # # # ### ####### ####### ### ##### # ##### # # # ### ####### ########### # ### # ######### 
#   #   #   # #   #     # #       #   #   #   #     # #   # # #       #       #   #     #       #   
# ### ####### # ### ### ### ####### ### # ##### ##### ##### # # ####### ##### # # ##### ##### # ####
# #   #       #   #   #     #     #     #       #   #       #   #     # #   # # # #   #     # #     
### ### # ####### ### ####### ##### ####### ##### ### ##### ####### # # # # ### ### # ##### ####### 
#   #   # #     # # #   #     #     #     # # #   #   #   #   #     #   # #   #   # # #   #         
# ### # ### ### # # ### ### # # ##### ##### # # # # ### # ### ### ####### ### ### # # # ########### 
#   # # #   #   #   # # #   # #   #   #     # # #     # # #     #         #     #   # #     #     # 
# # # # # ### ##### # # # ####### # # # ##### # ####### # ##### ########### # ##### # ### # # ### # 
# # # # # #   #     # # #       #   # #     #     #     #   # #         #   # #   # #   # # #   # # 
# # # # # # ### ##### # ### ### ##### ##### ##### # ####### # ######### # ### # # ##### # ##### # # 
# # # #   # #   #     #   #   #     # #   #     # #     # E # #         # # # # #       #       #   
# # ### ### # ####### ### ### # ##### # ####### ####### ### # # ######### # # # ##### ##############
# #   # #   # #   #     # #   #         #     #     # #   # #   #         #   #   #   #     #       
# ### # # ### # # # ### # ### ######### # ### # # # # ### # ### ######### ##### # ##### ### # ##### 
#   # # #     # #   #   #   # #       # # # # # # #     # #   #           #   # # #   # # #   #   # 
### # # ####### ##### ##### ### ##### ### # # # # ##### # ### ########### # # # # # # # # ##### # # 
#   # #   #     #   #   # #     #   #   # #   # # #     # #           #   # # # #   # # #     # # # 
# ### ### # ##### # ### # ######### ### # # ### # # ##### # ######### # ### # # ##### # # # ### # # 
# #   #     #     # #   #   #         #   # #   # #     # # #     #   # # # # # # #   #   # #   #   
# # ######### ##### ### # # # # ########### ### # ##### # ### ### # ### # # # # # # ### ##### ######
# #     #     #   #   # # #   #         # #   # # #   # #     # #S# #     # # #   #     #   #       
# ##### # ##### # ### # # ########### # # ### # # # # # ####### ### ####### # ### ####### # ##### # 
#   # # #   #   # #   # #           # #   #   # # # # # #       #   #       #   #     #   #     # # 
### # # # ### ### # ### ####### ##### ### # ##### ### # ### ### # ### ######### # ##### ####### ### 
#   # #   #   #     #       #   #     # # #     # #   # #   #   #   #   #       # #   # #   #   #   
# ### ##### ##### ######### # ### ##### # ##### # # ### # ### ##### ### # ######### # # # ### ### # 
#     #   #     # #   #   # # #   #           #   #   # #   # #   #     # #         #   #     #   # 
##### # ####### # # # # # # ### ### ############### # # # # # # # ####### ### ########### ##### # # 
# #   #       # # # # # #       #         #       # # # # # # # # #     # #   #           # #   # # 
# # ####### # # ### # ##### ##### ######### ##### # # # # # # # # # ### # # ######### ##### # ### # 
# # #       # #     # #   # #   # #       # #     # #   # # #   # # #   # #   #     #   #     #   # 
# # # ####### ####### # # ### # # # ##### # # ##### ##### # ##### # ##### # # # ### ### ####### ### 
# # # #       #     #   #     # # # #   #   #       #   # #     # #   #   # #     # # #         # # 
# # # # ####### ### ########### ### # # ############# # ####### # ### # ########### # ########### # 
#     #         #             #       #               #         #     #             #               
####################################################################################################
