         #         #
 ####### # ### ### #
 #     #   # # #   #
 # ### ##### # #####
   # # #     #     #
#### # ### ####### #
           #       #
 ########### ##### #
   # #     #   # # #
## # # ### # # # # #
     # #   # # #   #
###### # ##### ### #
       #     #   # #
 ##### ##### ### # #
 #     #S# #     # #
 ####### # ####### #
   #     #       # #
E# # ##### ####### #
 #   #             #
####################
