####################################################################################################
     #       #     #                     #     # #   #   #         #   #       #     #     #   #   #
 ### # # ### # ### # ####### ########### ### # # # # # # # ### ### # # # ### ### # # # ### # # # # #
   # # #   #   # # #   #   #   #       # #   #   # #   # #   # #     # # # # #   # # # #   # #   # #
## # # ### ##### # ### # # ### # ##### # # ##### # ##### ### # ####### # # # # ### # # # ### ##### #
   # #   #     #   #   # #   # #   # # #   #   # # #   #   # # #     # #   #     # #   #   # #     #
 ### ### ##### ##### ### # ### ### # # ##### # # # # # # ### # # ### # ######### # # ##### ### ### #
 # #   # #     #     #   # #   #   # #   #   #   #   # #     #   #   #     #   # # # #   #   # #   #
 # ### # # ##### ####### # # ##### # ### # ########### ######### # ####### # # ### # # # ### # # ###
 #     # #       #       # # #   #     #       #     #     #   # # #         #     # # #   # # #   #
 ### ### ########### ##### # # # ############### # # # ##### # ### ################# # ### # # ### #
   #   # #           # #   #   #               # # # # #     #   # #       #     #   #   # #   # # #
## ### # ### ######### # ####### ############# # # # # # ####### # # ##### # # ### ##### # ##### # #
   # # #     # #         #     # #           #   # # # #     # # # #     # # # #   # #   # #       #
 ### # ####### # ######### ### # # ####### ####### # # ##### # # # ### ### # ### ### # ### ##### ###
 #     #         #   #     # # # #   #     #       # # #   # #   #     #   #     #   #   #     #   #
 # ##### ######### ### ##### # # ### # ##### ####### # # ### # ######### ####### ### # ####### ### #
 # # #   #       #   #   #   # # #   #   #   # #   # #   #   # #       # #     #     # #       # # #
 # # # ### ### # ### ### # ### # # # ##### ### # # # # ### ### ### ### # # ### ####### # ####### # #
 #   # #     # #   #   # #   # # # # #     # #   # # # #   #       # #   # # #         # #   #     #
 ### # ##### # ### # # # # # # # # # # ##### # ### # # # ########### ### # # ########### # # # #####
 #   #     # # #     # # # #   #   # #   #   # #   # # #       #       # #     #   #     # # #     #
 ######### # # ##### ### # ##### ####### # ### # ### # ####### # ####### ### ### # # ##### # ##### #
   #     # # #   #   #   #     # #       # #   #     #       # # #       #   #   #   #   # #     # #
 # # ### # ##### ##### ####### ### ####### # ######### ####### # # ####### ### ####### ### ##### # #
 #   # # #     # #   #   #   #   # #       # #     #   #       #   #       # # #   # #   #     #   #
 ##### # ##### # # # ### # ##### # # ### ### # ### # ### ####### ### ####### # # # # # # ##### #####
     # #   #   # # #     #     #   # #   #   #   # # # #   #     #   # #     #   # #   #       #   #
#### # ### # ### # ####### # # ####### # # ####### # # ### # ##### ### # # ####### ##### ######### #
   # #   #   #   # #     # # #         # #     #   # #   # # #     #   # #       #     #     #     #
 ### # ####### ### ##### # # # ############### # ### ### # ### ####### # ### ######### ##### # ### #
 #   #         #   #   #   # # #     #       # # #   #   #   #       #     # #   #     #   #   #   #
 # ####### ##### ### # ##### ### ### # ##### # # # ### ##### ####### ####### # # # ##### # ##### ###
   #       #   # #   #     #   # # #   #   # # # # #   #     #     # #     # # # # #     #   # #   #
 ### # # ### # # # ####### ### # # ##### # # # # # # ### ### # ### # # ### # # # # # # ##### # ### #
 #   # # #   # # # #   # #     #     #   # #     #   #   # # # # #   #   # # # # # # #   #       # #
 ##### ### ### # # # # # # ######### # ### ##### ### # ### # # # ####### # # # # # ##### # ####### #
 #   # #   #     # # # #   #   #       #   #   #   # #   #   #           # # # #   #   # #   #   # #
 # # # # ######### # # ##### # # ########### # ##### ### # ############### # # ##### # # # ### # # #
   #   #   #   #     #       #   #   #       #         # #   #   #       # # #   #   #   # #   #   #
###### ### # # # ########### ##### # # ############### # ##### # # # ##### # ### # ### ##### #######
     #   # # # # #         #   #   # #   #           # # #     #   #         #   # #   #   # #     #
 ### ### # # # ### ##### # ##### ### # ### ######### # # # ################### ### ##### # # # # ###
 #     # #   #     #   # # #     # # # #   #       # # #   #             #   # # #       # # # #   #
 # ##### ##### ##### # # # # ##### # # # ### ##### # # ##### ######### # # # # # # ####### # # ### #
 #       #   #   #   # # #   #     #   # #   #     # # #     #   #   # # # #   #   #     #   # # # #
 ######### # ### # ### ### ##### # ##### # # ####### # ####### # # # ### # # ##### ### # ##### # # #
   #       #   # #   #   # #     #   # # # #     #   #     #   #   #     # # #   #   # #     #   # #
 ### ######### # ### ### # ### ##### # # ####### # ####### # # ########### ### # ### # ### # ##### #
 #   #   #     # #   #   #     #       #       # # #         # #         # #   # #   # #   # #     #
## ### # # ####### ##### ### ######### ####### # # ##### ####### ####### # # ### ### # # ### # #####
   # # # #         #   #   # #       #   # #   #       # #     # #     # #     #   # # # #   #     #
 ### # # ######### # # ### ### ##### ### # # ######### ### ### # ### # # ######### # ### ### ##### #
 #     #       #   # # #       #   # #   # #     #   #     #   #   # #   #     #   #   #   #       #
 ### ######### # ### # ######### # # # ### ##### ### ####### ### # # ##### ### # ##### ### ####### #
   # #       #     # #   #       # # # #     #   #         # #   # #     # # # # #   #     #   #   #
 # ### ##### ####### ### # # ####### # ### ### ### ### ##### # ### ##### # # # # # # ####### # #####
 #   # #   # #       #   # #         #     #   #   #   #     #   # # #   # #     # #     #   #     #
 ### # ### # # ####### ### ######### ####### ### # ##### ######### # # ### ####### ##### # ####### #
 #   #     #       #   #   #       #         #   # #   # #   #     #   #       #   #   # #   # #   #
 # ####### ######### ####### ##### ############### # # # # # # ##### ##### ### # ##### # ### # # ###
 #       # # #       #       #   #   #     #       # # #   #   #   # #   #   #   #     #   # # #   #
 ##### ### # # # ##### ####### ##### # ### # ####### # ########### # # # ### ##### ### # ### # ### #
 #   #   #   # # #     #   #       #     # #     #   #             #   #   #     # # # #         # #
## # ### ### # # # ##### # ####### ####### # ### # ######### ##### ####### ##### # # # ########### #
   #     # # # # #   #   #         #   #   #   # # #       # #   # #     #   # #   # #   # #     # #
 ####### # # # ##### ### ######### # ### ##### # # # ##### # ### # # ####### # ##### ### # # ### # #
     #     # #     #   #   #     #   #   #     #   #   # #   #   # # #   #   # #   #   # # # #     #
 ### ####### ### ##### # # # ### ##### ### ########### # ##### ### # # # # ### # # # # # # # ##### #
   #       #   #       # # # #         #         #   # #         #   # # # #     #   #   # #   # # #
## ####### ### ########### # ### ############### # # # ######### # ### # # ############# # ### # # #
   #     # #   #     #     #   # #       #     # # # #         #   #   #   #           #   #   # # #
 ####### # # ### ### ### # ### ### ##### # ##### ### ######### ##### ####### ######### ### # ### # #
         #   #     #     #   #     #     # #   #   #       # #             #   #     # # # # #     #
######## ##### ### ######### ####### ##### # # ### # # ### # ############# ### # # ### # # # ### ###
     #   #     # #   #   #   #     # #       #     # # #   #   #     #   # #   # # #   #   #   #   #
## # # ##### ### ### # # # ### ### # ########### ##### # ### # # ### # # # # ### # # ######### ### #
   # #     #       #   # #   # #   #           #       #     # #   # # # # # # # #   #         # # #
 ######### ############# ### # # # ########### ####### ########### # # ### # # # ####### ####### # #
       # #       #       #   # # # #       # #       # #     #     # #   #   #   #       #     #   #
#### # # ####### # ####### ### # # ##### # # ####### # # ### # ##### # # ##### ### # # ### ### #####
   # # # #     #   #     #   # # #   #   # #       # # # # #   #   # # #     # #   # # #   #   #   #
 # # # # # ### ##### ### ### ### ### # ### # ### # # # # # ####### # # ##### # # ### # # ### ### # #
 # # #   #   #     # # #   #     # # #   # # #   # # # #           # #   #   # #   # # #   #     # #
 # # ####### ### ### # ### ####### # ### # ### ##### ### ######### # ##### ### ##### ##### ####### #
 #   #   #     # #     #       # #   #   #   #   #   #   #       # #     #     #   #     # #   #   #
 ##### # # ##### # ##### ##### # # ### ##### ### # ### ### ##### # ##### ### ### # ##### # # # # # #
       #   # #   #   #   #       # #   #     #   #       # #   # #     #   #     #     # #   # # # #
 ########### # ##### # ########### ### # ##### # ######### # # # ####### # ########### # # ##### ###
     #     # #       #   #     #       #     # #     #   # # # # #     # # #     #   # #   #   #   #
#### ### # # ########### # ### # ########### # ##### # # # # ### # ### ### # ### # # # # ### # ### #
   #     #     #   #     # # #   #   # #   # # #   # # # # #   # # # #   #   #   # # # # #   #     #
 ############# # ### # ### # ##### # # # # # # # # # # # # ### # # # ### ### # ### # # ### #########
   #       #   #   # # #       #   # # # # #   # #   # #   #   #   #   #   # #   # # #   #         #
 # # # # ### ### # # ### ####### ### # # # ##### ##### ##### ####### ##### # ### # # ### ######### #
 #   # # #   #   # #     #       # # # # #       #   # #     #       #     #   # # # #   #   #     #
 ##### ### ### ### ####### ####### # # # ##### ##### # ### ### ### # # ######### # ### ### # # ### #
 #     #   #   #   #     #   # #   # #   #   #       #   # #   # # # #   #   #   #   #     # # #   #
 # ##### ####### # ##### ### #E# # # ##### # ########### # # ### # ##### # # # ### # ####### # # ###
 #               #       #S  #   #         #             #       #         #   #   #           #   #
