 #           #     #
 # # ####### # #####
   # #   #   # #   #
 ### # # # ### # # #
   # # # # #     # #
## # ### # ####### #
   #   # # #     # #
 ##### # # # ### # #
     # #     #S#   #
 ##### ####### ### #
 #   #     #   #   #
## # ##### # ### ###
   #   #   # # # # #
 ##### # # # # # # #
 # E # # # # #   # #
 # ### # # # # ### #
 #       # # #   # #
 ########### ### # #
             #     #
####################
