#   #       #     #     #                     #     #       #             #   #             #       
# # # # ##### # # ### ### ######### ### ####### # ### ### # # ####### ### # # ####### ##### ### ### 
# # # # #     # # #   #   #       #   # #     # # #   # # # # #   # #   #   #   #     #   #     #   
# ### # # ##### # # # # ##### # ##### ### ### # # # ### # ### # # # ### ####### # ##### ######### ##
#   # #     #   #   # #     # # #     #   # #   # # #   #     # #   # # #     #   #         #   #   
# # # ####### ############# ### # ##### ### ##### # # # ####### ### # # ### ####### ####### # # ### 
# #   #   #   #   #     #   #   #       #       #   # #   #     #     #   #       #     # #   #   # 
# ##### # # ### # # ### # ### # ######### ##### ####### # ### ########### # ##### ##### # ##### ### 
#   #   # #   # # # # # # #   # #     #   #   #         #     #           #   # #       #     #     
### # ### ### # # # # # # ### # ### # # ### # ##### ####### ### ############# # ########### # ######
#   # #     #   # #   #   #   #     # # #   #     #   #   # #   #       #           #       #   #   
# ##### ######### ### ##### ######### # # ####### ### # ### # ### ### ### ######### ### ####### ### 
#     #     #       # #     #   #   # # # #   #   #   #     # # # # # #   #       # #   #     #     
##### ### # # # ##### # # ### ### # # # ### # # ### ### ##### # # # # # ### ##### # # ### ######### 
#   #   # # # # #     # # #       #   #     #   #   #       # #     # #   # # #   #   #   #       # 
### ### ### # ### ####### # ################# ### # ####### # ####### ### # # # ####### ### ##### # 
#     #   # #     #       #   #       #       #   # #     # #     #   #   #   #   #       # #   #   
# ### ### # ####### ######### ### ##### ####### ### # ### ####### # ### ##### ### ####### # ### ####
# #     # # #       #           #         #     #   # # #   #     #     #       #       #   #   #   
# ##### # # # # ##### ######### ### ####### ######### # ### # ####### ### ############# # ### # # # 
# #   # # # # # # #   #   #   #   # #     #         # #     #       # #   #         #   # #   # # # 
# # # ### # # # # # ### # # # ### ### ### # ####### # # ########### # # ### ####### # ### # ### # ##
# # #     #   # #     # #   #   #   # # # #       # # #             # # #   #     #   # #   #   #   
# # ########### ####### ####### ### # # # ######### # ##### ######### # # ### ### ##### ##### ##### 
# # #   #       #       #     #   #   #       #     #   #   #   # #   # #     # # #         #     # 
# # # # ### ### # ######### # ### # ######### # ##### # ##### # # # ### ####### # ####### ####### # 
# # # #   # #   # # #       # #   # #       #   #  S# #       # #     # #       #       #         # 
# # # ### # # ### # # # ##### # ##### ##### ##### ### ######### ####### ### ### ####### # ####### # 
#   # # # # #   # # # #     # #       #   #   #   # # #     # #             #         # #   #   #   
# ### # # # # ### # # ##### ########### ##### # ### # # ### # ######### ############### ##### # ### 
# #   #     # #   # #     #         #       #   #   #   # # # #   #   # #       #     #       # #   
# # ##### ##### ### ##### ##### ### ##### # ####### ##### # # # # # # ### ##### # ### # ####### ####
#   #   # #     #       #     # # #   #   # #     #     #   # # #   #   # #   #   #   #       #     
# ### # # # ########### ### ### # ### # ### ### # ### # # ### # ####### # ### ##### ########### ### 
# #   # # # # E       #     #   #   # # #   #   # #   # #     #     #     #       # #         #   # 
# # ### # # ### ##### ### ### ### ### # # ### ### # ####### ##### # ####### ##### # ### ##### ### # 
# #   # # #   # #   #   # #   #     #   #     # # #         #   # #   # #       # #     #   #   # # 
# ### # # ### # # # ### # # ####### ########### # ########### # ##### # # ##### ######### # ### # # 
#   # # #   # # # #   # # #   #   #       # #       #   #     #   #   #       #         # #     # # 
# ### # ##### # # # # # ### # # # # # ### # # ##### # # # ####### # ### ######### ##### # ######### 
# #   #     #   # # # #   # #   # # # #     # #   # # # # #       #   #   #   #   #     # #       # 
# # ####### ##### # # ### # ##### # # # ##### # # # # # # # ######### ##### # # ####### # ### ### # 
# #   #   #       # # #   # #     # # #   #   # # #   # # # #   #   #     # # #       # #   # #     
##### # ########### ### ##### ##### # ##### ### # ##### # # # # # # ##### # # ##### # # ### # ######
#     #           #     #     #     #         # #   #   # # # # # #     #   #     # # # # # # #     
# ####### ### ########### ##### ############# # ### # ### # # # # ##### ######### # # # # # # # ### 
#   #   #   #           #     # #   #     #   #   # #     #   #   #   #           # # #   # # # # # 
### # # ### ######### # # ### ### # # ### ####### # ############### # ############### ### # # # # # 
#   # # #   #       # # # #   #   # # # #       # #   #           # # #   #     #     #   # # # # # 
# ### # ##### ##### ### # # # # ### # # ####### # ### ##### ####### # # # # # # # # ### ### # # # # 
#     #     #   # #   #   # # #   # #     #   #     #     #   #   # #   #   # # # # #     # #     # 
########### # # # ### ##### ##### # ##### ### ####### ### # # # # # ######### ### # ##### # ####### 
#     #   # # # #   #     #       #     #       #   #   # # #   # # #       # #   #   #   #         
# # ### # # ### # ####### # ######### ### ####### # ##### ### ### # ####### # # ##### ############# 
# # #   # #     #     #   # #       #     #       #     #   #   #       #   #   #   #   #         # 
# # # ### ####### # # # ##### ##### # ##### ### ####### ### ### ####### # ######### ### # ### ### # 
# #   # #       # # # #   #   #   # #   # # #   #   #       #     #   # #         #   #   # #   # # 
# ##### ####### # # # ### # ##### # ### # # # ### # ### ######### # # # ####### # # # ##### ### # # 
# #     #     #   # #   #   #     # #     # # #   #   # #   #   # # # #         #   # #       # # # 
# # ### # # # ##### ######### # # # ####### ### ##### ### # # # ### # ############### # ### ### ### 
#   # # # # # #   # #       # # # #       # #   #   #     # # # #   # # #           # # # # #   #   
##### # ### ### # # # ### # # # ######### # # ### # ####### # # # ### # # # # ####### # # # # # # ##
#   #   #   #   #   # # # # # # #         #   #   # #   # #   # # # # #   # # #       #   # # # # # 
# # # ### # # ##### # # # ### # # ########### # ### # # # ##### # # # ##### ### ######### # # # # # 
# #       # #   #   # # #     # #           #   #     #   #   # # # #     #     #         # # # # # 
# ########### # ### # # ####### ########### ############# # # # # # ##### ### ##### ####### # ### # 
# #         # #   # # #       #     #       #   #       # # # #         #   # #   # #     # #     # 
### ####### ### # ### # # ######### # ####### # # ##### ### # ######### ### # # # # # ##### ####### 
#   #     #   # #   # # # #     #   # #       #   #   #     #   #   #   #   #   # #   #     #       
# ### # ##### # ### # # ### ### # ### ##### ####### ########### # # ##### ####### ### # ### ####### 
# #   #     # # #   # # #   # # #   #     # # #               #   # #   # #     # #   #   #   #   # 
# ####### ### # # ### # # ### # ### ##### # # # ############# ##### # # # ### ### ####### ### # # # 
#       #     # #       # # #   #     # #   #   #           #   # #   # #   #     #       #     #   
# ##### ### ### ######### # # ### ### # ######### ######### # # # ##### ### ##### # ############### 
#     #   #   #     #   # # #   #   #             #         # #       # #   #   #   #   #   # #   # 
##### ### ### ##### # # # # ### ### ############### ######### ### ##### # ### # # ### # # # # # # # 
# #     #   #   #   # #   #   #     #       #       #     #   #   #     #     # # #   #   # #   #   
# # ####### ### ##### ##### # ####### ##### # ######### # # ### ### ##### ##### ### ####### # ######
#   #     # #   #     # #   #   #   # #   # #   #     # # # # #   # # #   #   #   # # #     #   #   
# ### ### # # ### ##### # # ### # # # # ### ### # ### # # # # # ### # # ##### ### # # # ####### # ##
# #   #   # # #   #     # # #   # #   # #   # # # #     #   #   #   #   #       #   # #   # #   #   
### ### ### # # ### ### # # ##### ##### # # # # # ##### ####### # ### ##### ### ##### ### # # ### # 
#   #     # #   #     # # # #     #     # #   # #     # #     # # #         #   #   #   # #     # # 
# ####### # ####### # ### # # ##### ##### ### # # ### ### ### # # ########### ### # ### # ##### # # 
#     #     #     # # #   #   #     #     # # # # #   #   #   # # #   #     #   # #     #     # # # 
# ### ####### ### # # # ########### # ##### # # ### ### ### ### # # # ### ##### # ##### ##### # ### 
#   #       # # # # #       #     # #   #     #   #       #   # # # #   #     # # # #   #   # #   # 
### ####### # # # ######### # ### # ### ##### ### # ######### ### # ### ##### # # # # ##### # ### # 
#   #     # # # #     #   #   #     #   #   #   # # #     #   #   # # # #     # # #   #     # # # # 
# ##### # # # # ##### # # ########### ### # ### # ### ### # # # ### # # # ##### # ### # # ### # # # 
#   #   # #   #     #   #     #     #     #   # #     # # # # #     #   #       #   #   # #   #     
### # ######### ########### # # ### # ####### ######### # # ######### ####### ##### ####### ####### 
# # # #             #     # #   #   #       # #           #     #     #     #       #     #     # # 
# # # # ##### ##### # ### ####### ########### # ####### ####### # ##### ### ####### # ### ##### # # 
# # #   #   #     # #   #       #       #     # #     #         #   #   # #     #   # # # #     #   
# # ##### # ##### # ### ####### ####### # ##### # ### ####### ##### # ### ##### ##### # # # ##### ##
#   #   # #   #   #   #       #         #       # # # #     # #   #   # #       #     # # # #     # 
# ### # # ### ####### ####### ################### # # # ### ### # ##### # ####### ##### # # # ##### 
#     #   #                 #                       #     #     #                 #         #       
####################################################################################################
