 #       #     #   #
 # # ### # ### ### #
   #   #   #       #
 ##### # ######### #
   #   # #       # #
 ### ### # ##### # #
 #   # # # #     # #
 # ### # # # ##### #
 # #     # # #     #
 # ##### # # ##### #
 #     # # #     # #
 ##### # # ##### # #
   # # # # # E # # #
## # # ### # ### # #
 # # #   #   #   # #
 # # ### # ### #####
 #     # # #S#     #
 ##### # # # ##### #
       #   #       #
####################
