####################
### ### # # # # # ##
 # # # ####### #####
# ##### # # ### # S#
 ### ####### #######
# ### # ### ##### ##
 ##### # # ### # # #
### # ##### ### ####
## ##### ### # ### #
# ##### # ##########
 ### # ##### # # # #
### # ### # ### ####
 ##### # ######### #
# # ##### # # # ####
 ### ########### # #
# ### # # #E### ####
## ### ####### ### #
####### ### ### ####
 # # ### # # ### # #
# # # ### ### # # ##
