####################################################################################################
               #   #                       #   #           #         #         #           #       #
######## ##### # # # ############# ####### # ### ### ##### ### ####### ### ##### ### ##### ##### # #
     #   #   #   # #             #     # # # #   # #     #   #   #   #   #     # # #   #   #   # # #
 ### # ### ####### ############# ##### # # # # ### ##### ### ### # # ### ##### # # ### # ### # ### #
   #   #   #     #             # #   # #   #         #   # #   #   #   # #   #     #   #     #     #
 # ##### ### # # ####### ##### # # # # # ############# ### ### ### ### # # ######### ############# #
 #     #     # #     #   #   # # # #   #     #         # #   #   # # # #   #   #   #   #   #       #
 ##### # ##### ### ### ### # # ### ######### # ######### # # ### # # # # ### # # # ### # # ##### ###
   #   #   #   #   #   # # # # #   # #       # #   #     # #   # #   #   #   #   #     # #     # # #
#### ####### ### ### ### # # # # ### # ##### # # # # ### # ### # ######### ########### # ##### # # #
     #   #   # # # #   # #S# #   #   # #   # # # # # #   #   # #   #       #         # # #   # # # #
 ##### # # ### # # ### # ### ##### # # # # # # # ### # ##### # ### # ####### ####### ### # ### # # #
   #   #   #   #     # #   #     # #   # # #   #     #     # #     #   #     #   #   #   #     # # #
## # ####### # ##### # ### ##### ####### # ##### ####### # # ######### # ##### ### ### ### ##### # #
   #   #     #     # #   # #     #       #   # # # #   # # #         # #   #     #     #   #   #   #
 ### # ##### ##### # ### # # ##### ######### # # # # # # # ######### # ### # ### ####### ### ##### #
   # #     #     # #   #   #   # E #   #   # #     # #   #     #   #     # #   #       # #   #     #
 # # ##### # ### ### ##### ### ### # # # # # ##### # ######### ### ### ### ### ### ### # ### # #####
 # #     # #   #     #     # #     # #   # # #   # # #               # #   # #   #   # #   # # #   #
 # ### ### ### ####### ##### ####### ##### # # # ### ######### ####### # ### ### ### ##### # # # ###
 # #   #   # #   #     #       #   #     #   # #     #   #   # #       # #     # # #     # #   #   #
 # ### # ### ### # ##### ### # ### ##### ##### ####### # # # # # ####### ### ### # ##### # ### ### #
 #   # # #     # #   #   #   #         # # #           # # # # #     # #   #           # #   #   # #
 ### ### # ### # ### # ### ##### ####### # # ########### # # ####### # ### # ########### ### ### # #
   # #   #   #   #   #   # #   # #       # # #       # # # #       # # #   #   #     #   #   #   # #
 ### # ########### ##### # # # ### ####### # # ##### # # # ### ##### # # ##### # ### # # # ##### # #
 #   #           # #   # #   #   # #   #     #   #   # #     #         #     # #   #   # #     #   #
 # ##### ####### # # # ### ##### # ### # ####### # ### ####### ############# # ### ##### ##### ### #
 #     #   #   # #   #   #     # #   # # #       # #   #     # #   #       # # #   #     #     # # #
 ##### ### ### # ####### ##### # ### # # ### ##### # ### ### ### # # ##### # # # ##### ### ##### # #
 # #   #       # #     #     # # #   # #     #   # #   #   #     # # #   #   # #     #   #     #   #
 # # ####### ### # # ####### ### # ### ####### # # ### ### ####### # ### ##### ##### # ####### # ###
 # #       # #   # #         #   #   #     #   # #     # #     #   #   #     # #   # # #     # # # #
 # ####### ### ### ########### # ### ### # # ######### # ##### # ##### # ### # ### # ### # ### # # #
 #   #   #   #   # #           #   # #   #   #       # #     # #   #   # #   # #   # #   #     #   #
 # ### # ### # # # ### ### ######### # ####### # ##### ### # # ### # ### ##### # ### # ########### #
 #     #   # # #   #   # # #   #   # #   #     #     #   # # #   #   #   #     #   #   #         # #
 ######### # # ##### ### # # # # # # # # # ##### ### ### ### ### ####### # ####### ##### ### ##### #
   #       # #     # #     # #   #   # #   #   #   #         # #       #   #           #   #       #
## # ####### ##### # # ##### ############### # ### ######### # ####### # ### ############# #########
   #   #     #   # # #     # #   #           # #   #   #     #       # #   # #             #   #   #
 ##### # ####### # # ####### ### # ### ####### ##### # # ##### ##### # ### # # ############# # ### #
       #   #   #   # #     #   # #   # #     #   #   # #   #     #   # # # # # #     #   #   # #   #
########## # # # ### # ### ### # ### # # ### ### # ### ### ##### # # # # # # # # ### ### # # # # # #
         #   # #   # # # #     # #   # #   # #   # # # #   #   # # # # # # #   #   #   # # # # # # #
 ####### ##### ### # # # ####### # ### # # ### ### # # ### # # ### ### # # # ##### ### # # # # # ###
 #     #     # #   # #     #   #     # # #     #   # #   # # #   # #   # # #     #   # #   # # #   #
 # # ####### # # ### ##### # # ####### # ####### ### ### # # ### # # ### # ##### ### # ##### # ### #
 # #   #   #   #   # #     # #         # #     # # #     #   #     # #   # #       # #     # #     #
 # ### # # ####### # # ##### ########### ### # # # # ##### ######### ### # ####### # ##### # ##### #
 #   #   #       # # # #       #   #   #     #   # # # #   #         #   #       #   #   # # #   # #
 ### ####### # ### # # ####### # # # ############# # # # ### ######### # ####### ####### # # # # ###
   #   #   # #       #   #   #   # #         #     # #     #   #       # #     #   #   #     # #   #
 # ##### # ######### ### # # ##### # ### ### # ### # ##### ### ### ##### ### # ### # # ####### ### #
 #       #       #     #   # #   # # # #   # #   # #     #   #   # #     #   #   #   # #       # # #
 ############### ##### ##### # # # # # ### # ##### ##### ####### # ##### # ########### # ####### # #
     #         #   #     # #   # # # # #   # #   #     #     #   #     #   #         # # #       # #
#### # ####### ### ##### # ##### # # # # ### # # # ### ##### # ### ### ##### ##### ### # # ##### # #
     #     # #   #     # #     #   #   # #     #   # # #   #   #     #   #   #   #   #   #     # # #
 ######### # ### ##### # # ### ####### # # ######### # # # ############# # ### # ### ##### ### ### #
 #     #   #   #     # #   # #   #   # # # #   #   # # # #             # #   # #       # #   #     #
 # ### # ### # ##### # ##### ### # # # # ### # # # # # # ##### ####### # ### # ####### # ### #######
 #   # # #   #   #   #     #   # # #   # #   # # # #   # #     #     # #     # # #         #     # #
 ##### # # # ##### ### ### ### # # ##### # ### # # # ### # ##### ### # # ##### # # ############# # #
       # # # #   # # #   # #   # #   # #   # #   # #   # # #     #   # #     # #   #   #         # #
#### ### # # # # # # # ### # ### ### # ##### ##### ##### # # ### # ### ####### # ##### # ######### #
     #   # #   # # #   #   # #   #   # #       #   #     # #   # #   #   #   # # #   # # #       # #
 ##### ### ##### # ##### ### # ### ### # ##### # ### ##### ### # ####### # # # # # # # # ##### # # #
 #   #   # #     # #   # #   #   #   #   #     #     #   # #   #       #   # # #   #   #     # #   #
 # ##### # # ### # # # # # # ### ### # ### ############# # ### ##### ####### # ####### ##### # ### #
   #     # #   # # # #   # #     #   #   #       #       #   # #   #   #   #   #       #   # # #   #
## # ####### # ### # ##### ####### ########### # # ##### ### # ### ### # # ##### ######### # # #####
   # #     # #       #         #           #   #   #     #   #   #   #   #     # #       # # #     #
 ### # ### ######### ######### ########### # ############# ##### ### ######### # # ##### # # # ### #
   #     # #     #   #       #     #   #     #           # #   #   #     #   #   #   #     # # #   #
#### ##### # ### ### # ##### ##### # # # ##### ######### # # # ### # ### # # ##### # ##### # ### ###
   # #   # #   #   # #   #   #   # # # # #   # #       #   # # #   #   # # #       #     # #   #   #
 # ### # # ### ### ### ### ##### # # # # # # # ####### ##### # # ### ### # ############# # ### ### #
 #     #   # # # #     #   #     #   # # # # #       #   #   # # #   #   # #       #   # # #   #   #
 ### ##### # # # ####### ### # ####### ### # ####### # # # ### # ### # ### # ####### # # # # ### ###
 #   #   #   # #     #   #   #       # #   # #       # #     # #   # #   #   #       #   # #   #   #
 ##### # ### # # ### # ##### ##### ### # ### # ########### ### ### ##### ### # ####### ####### ### #
       #   # #   # # #     # #   # #   #   # #           # #     #   #     # # # #   # #     # #   #
 ######### ####### # ##### # ### # # ##### # ####### ### ### # ##### # # ### # # # # # # ### # # ###
   #     #       #   #   # #   # #   #     #       #   #   # # #     # # #   # # # #   # # #   #   #
## ### # ####### # ### ### ### # ##### ########### ### ### # ### ##### # # ### # # ##### # ####### #
 # #   # #     # # #     #   #   #     #         # #   #   #     #     # # #   #     # # #         #
 # # ### # ### # # # ### ### ### ##### # ######### # ### ### ##### ##### # # ####### # # # ##### # #
 # # # # # #     # #   #   #   #       # #       # # #   #   #       #   # #       #   # #     # # #
 # # # # # ####### # ##### ### ######### # ##### # ### ### ######### ##### ####### ### # ##### # ###
 #   #   # #       # #   #   #   #       # #   #   #   #       #   #         #   #   # #     # #   #
 ##### ### # ######### # # # ### # ####### # # ##### ######### # # ########### # ### # ##### ##### #
     # # #   #         # # # #   #   #   # # #   #   #       #   #     #       #     # #     #   # #
 ##### # ##### ######### # ### ### # # # # # ### ### # ##### ######### # ############# # ##### # # #
   #   #         #       #   # #   #   #     # #   # # # #   #     #     #           # #     # # # #
 # # ########### # ####### # # # ############# ### # # # # ### ### # ##### ######### ####### # # # #
 # # #           #   #   # # # #     #       #       #   #   # # # # #   #       # #   #     # #   #
 # # ### ########### # # ### # ####### ##### ########### ### # # # ### # ####### # ### # ##### ### #
 #       #             #     #             #               #     #     #             #         #   #
