####################################################################################################
#       #       #                 #               #   #   #           #         #                   
# # ##### # ### # ############### # ##### ####### # ### # # # ####### ####### # ##### ##############
# # #   # # #   #   #   #       #   #   #     # #   #   # # # #     #   #     # #   #           #   
# # # # # # ### ### # # ### ### ##### # ##### # ### # ### # # # ### ### # ##### # # ########### # # 
# #   #   #   # # #   #   #   # #     #   #   #     #   #   #   #   #     #   # # #           #   # 
# ########### # # ####### ### ### # ####### ########### ######### # ####### # # # ########### ##### 
#   #       # #       # #   #     # #     # #           #   #     # #     # # # # #   #   #   #   # 
### # ### # # ####### # ### # ##### # ### # # ########### ### ##### # ### ### # # # # ### # ### # # 
# # # # # # #     # #     # # #   # # #     # #             # # #   # # #   # #   # #   #   #   #   
# # # # # ####### # # ##### ### # # # ##### # ### ######### # # # ### # ### # # ### ### ### # ##### 
# # #   #     # # #   #     #   #   #     # #   #   #       # # # # #   #   #   #     #   #   # #   
# # # ##### # # # # ### ##### ########### ##### ### # ##### # # # # ### # ####### ####### ##### # ##
#   # #     #   # #   #   #             #     # #   #   # # # # #   #   #       #   #   #   #   #   
# ##### ####### # ####### ############# ### # # ### ### # # # # ### # ######### # ### # ### # ##### 
#       #     # #       #             # #   # #   # #   # # # #     #       # #   #   #     #       
######### ### # ####### ############# # # ### ### ### ### # # ### ######### # ##### ##### ####### ##
#       # #   # #     #         #   # # #   # # #     # #   #   # #       #   #   # #     #     #   
# # ##### # # # ### ##### ##### # # # # ### # # ####### # ##### ### ### ##### # # # # ##### ### ### 
# #       # # #   # #   #     #   # #   # # #       #   #     # #   # #   #   # # # # #     # # #   
# ######### # ### # # # # ######### ### # # ####### ### ##### # # ### ### # ##### # ### ##### # # ##
# #   #     # #     # # # #       #       # #   #       #     #         # #       #     #   # # #   
# # ### ####### ##### # ### ##### ######### # # ######### ########### ### ####### ####### # # # ####
# #   # #   #   # #   # #   #   # #     #   # #     #     #       # # #       # #   #     #   #     
# ### # # # # ### # ### # ### # # # ### # ### ##### # ##### ##### # # # ##### # ### ##### ##### ### 
#   # # # #   #   # #     #   # #   #   #     #   #   #   # #   # #   #   #   #   #     # #   #   # 
### # # # ####### # ####### ######### ####### # ##### # ### # ### # ##### # ### # ##### # # # # ### 
#     # #   #     #   #     #         #     #   #   # # #   #     #   #   # #   #   #   # # # # #   
####### ### ### ##### # # # # ########### # # ### # # # # ##### ####### ### # ####### ### # # # # # 
#     #   #   # #   # # # # #   #         # # #   # #   #     #         #     #   #   #   # # # # # 
# ### # ##### # # # # ### # ### ### ####### ### ### ### ##### ######### ##### # # # ##### # # ### # 
# # #S#         # #   #   # # #     #     #     # #   #     #   #   #   #   # # # #       # #   # # 
# #E############# ##### ### # ####### ########### ### ##### ### ### # ### # ### # ####### # ### # # 
# #     #   #     #     # # #     #           #     #     #   #   #   #   #     #         #   #   # 
# # ### # # # ##### ##### # ##### # ##### # ### # ####### ### ### # ### ################### # ##### 
# #   #   #   # #     #           #     # # #   #         # #   # # #   #   #       #     # # #   # 
# ### ######### # ### ##### ##### # ##### ### ############# ### # # # ### ### ### # # ### # # # # # 
#   #   #   #     # #     # #   # # #     #   #       #       # # # # # #     #   # #   # # # # #   
### ### # # # ##### ##### ### # ### # ##### ##### ### # ##### # # # # # # ##### ####### # ### # ####
#   #   # #   #     #     #   #     # #     #     #   # #   # # # # # #       #       # #     # #   
# ### ### ##### # ### # ### ######### # ##### ######### # # # # # # # ############# # # ####### ### 
#   # #   #     # #   # #   #         # # #             # #   # # # # #           # # # #     #   # 
### # # ######### # ### # ### ####### # # # ############# ##### # ### # ######### # # # # ####### # 
#   # # #       # # #   #   # #       # #   #   #   #   #       #     # #     #   # # # #   #   #   
# ### # ### ### # # # ##### # ####### # # ### # # # ### ############# # # ##### ### ### # # # # ### 
#   # #   # #     # # #     #       # # #     # # #   #       #     # # # #   # #   #   # # # #     
### # ### # ####### ### ########### ### ####### # ### # ##### # ### # # # # # # # ### ##### # ######
# #   # # #       #     #         #     #     #   # # # #     # #   # # #   #     #   #     # #   # 
# ##### # ####### ######### # ### ####### ### ##### # # ####### # ### # # ######### ### ##### # # # 
#   #   #         #       # # # # #       # # #       #   #     #   #   # # #       #   #   # # #   
# ### # ######### # ### # ### # # ### ##### # # ####### # # ####### ##### # # ####### # # # # # ### 
#     #       #   #   # # #   # #   # #       # #   #   # # #     #   # # # # # #   # #   #   # # # 
# ########### # ##### # # # ### ### # # ####### # # # ### # ### ##### # # # # # # # # ######### # # 
# #     #     #   #   # #   #         #       #   # # #   #   #   #   #     # #   #   #     #   #   
# # ### # ####### # ### ##### ############### ##### ### # ### # # # ### ##### ####### ### ### # # ##
# #   # #   #   # # #   #     #   #     #     #   #     # # # # # #   # #     #     #   #     # #   
# ### ##### # # # # # ######### # # ### ####### # ####### # # # # ### ### ##### ### ### ### ### ####
#     #     # #   # #           # # # #         #   #       # # #   #   #     # # # #     #   #     
# ##### ##### ####### ########### # # ############# # ####### # # ##### ##### # # # ##### ##### ### 
# #   #     #       #     #       # #             #   #   #   # #     #     #   # #   #       # # # 
# # # # ### ####### # ##### # ##### # # ######### ##### # # ####### # ##### # ### ### ####### # # # 
# # # #   #   #     # #   # # #       # #       #       # # #     # #     # #       #     # # #   # 
### # ##### ### ####### # # # # ####### # ##### ########### # ### # ##### # ####### ##### # # ##### 
#   #     #   # #     # #   # # #   #   #     #           #   #   # #   # # #   #     #   # # #     
# ####### ### # # # # # ####### # # # ####### ########### ##### ##### # # # # # # ##### ### # # ### 
#   #     #   # # # # #         # # #       #     # #     #     #   # # # # # #     #   # #   #   # 
# # ##### # ### # # # # ######### # ############# # # ##### ##### # # # # # ######### ### # ### # ##
# #     #   #   # # # #   #     # #               # # #   #   #   #   #   #   #       #   #   # #   
# ##### # ### ##### # ##### ### # ################# # # # ### # # ########### # ####### # ### # ### 
#   #   # #   #     #     # #   #     #     #     #   # #   # # #           #   # #     #   # # #   
### # ### # ### # ####### # # ####### # ### # ### # ### ### # ########### ####### # ### ##### ### # 
# # #   # # #   #     #   # # #       # #     #   #   # # # #   #         #       #   # #   #     # 
# # ### # # ######### # ### # ### ##### ##### ####### # # # ### # ######### # ####### # # # ####### 
#   #   # #   #       #   # #     # #   #   # #       # #       #       #   #       # # # # #     # 
# ### # ##### # ######### # ####### # # # # ### ####### ######### ##### # ####### ### # # # # # ### 
# # # # #   # # #       # # # #       # # #     #   #     #   #       #     #   # #   # # #   #     
# # # ### # # # # ##### # # # # ####### # ####### # ##### # # ####### ####### # # # ### # ##########
# # #     # #   #   #   #   #   #     #   # #     # #   # # #   #     #       #   # #   # #       # 
# # ####### ######### ####### ### ######### # ### # # # # # ### ### ### ########### # # # ### ### # 
#   # #   #         # #       #   #         # # # #   # #     #   # # #             # # #     # #   
### # # # ### ##### # # ####### ### ### ### # # # ##### ######### # # ############### # ####### ### 
# # # # # #   #     # #     # #   # # #   # # # # #         #     # #     #   #   #   #     #     # 
# # # # # # ####### # ##### # # # # # ### # # # # ######### # ##### ### # # # # # # ####### # ### # 
#     # #   #     # #   #   #   # #     # # # # #       #     #   # #   # # #   # #     #   #   # # 
# ##### ##### ### # ### # ### ### ##### # # # # ##### # # ####### # # ### # ##### ##### ####### # # 
# #   #       #   #   # #   #   # #     # # # # #   # # # #     #   # #   # #     #   #     #   #   
### # ######### ##### # ### ##### # ##### # # # # # # # ### ### # ### # ### ### ### ####### # ######
#   #     #     #   #   #   #   #     # # # #   # # # # #   #   #     # #     #     #     #   #     
# ####### # ####### ### # ### # ##### # # ##### # # # # # ### ######### ### # ##### # # ####### # # 
#       #   #     #     #     #   # # # #       # # # #     #   #     #   # # #     # #     #   # # 
# ##### ### # ### ############### # # # ######### # ####### ### # # ##### # # ####### ##### # ### # 
#     # # # # # # #   #           # # #         # #       # #   # # #     # #   #     #   # #   # # 
####### # # # # # # # # ########### # ##### ### # ####### # # ### # # ######### # ####### # # ### # 
#       #   # # #   # # #           # #     #   # #     # # #   # # #         # # #     # #   #   # 
# # ##### ### # ##### # ####### ##### # ######### # ##### ##### ### ######### # # ### # # ##### ### 
# # #   # #   #     # #       # #       #     #   #       #   # #   #       # #       #   #     # # 
# ### # ### ##### # # ####### # # ####### ### # ### ####### # # # ### # ### # ##### ####### ##### # 
# #   # #   #     # #         #   #       #   #   # #       #   #     # #   #     # #     #   #   # 
# # ### # ##### ### ############### ####### ##### # ### ######### ##### ######### ### ### ### # ### 
#     #         #                   #             #     #             #               #       #     
